term	def
آب	August
أب	father
إباحة	permissiveness, lack of restraint
إباحي	permissive, uninhibited
إبادة	extermination
أَباط	armpit
إبتِداء	beginning
إبتِدائي	initial, primary
إبتِزاز	blackmail
إبتِسام	smiling (n.), woman's name
إبتِسامة	a smile
أَبجَدي	alphabetical
أَبجَدِيّة	alphabet
أَبَد	eternity
أَبَداً	never, not at all, absolutely not
إبداع	creating, creation, creativity(?)
إبرة،أُبَر	needle, injection, jab, shot
أَبرَد	colder, coldest
أَبرَز	more/most protruding, prominent, obvious
أَبرَشِيّة	diocese
أَبرَص،بَرصاء،بُرص	leper, albino
أَبرَك	more blessed
أَبسَط	most simple, small, insignificant, small quantity
أَبصَر	more/most seeing/knowing/understanding
أبْصَر	God knows
أَبعاب	fees
إبعاد	banishment, deportation, expulsion
أَبكَم،بَكماء،بُكُم	dumb, unable to speak
إبن،أَبنا	son
اِبِن،وْلاد\أولاد	son
أُبَّهة	magnificence, splendour, magnificent, splendid, impressive
أُبُوّة	fatherliness
أَبيَس	more/most dry
أبْيَض،بيضا،بيض	white
أَتات/أَثاث	furniture
إتِّجاه	direction
إتِّحاد	unity, union
أَتخَم	more/most thick (esp. elongated tubular objects)
إتِّصال	link, connection, contact, phone call
إتِّفاق	agreement
إتِّفاقِيّة	contract, acreement
أَتقَل	more/most heavy
إتِّكال	trust, reliance, confidence
إتِّكالي	dependent, relying on others
أُتُماتيكي	automatic
أَتمَن	more/most valuable, precious
إثبات	proof, evidence
أَثبَت	more/most fixed, firm, steady, permanent, stable
أَثَر،أَتَر،آثار،آتار	track, sign, trace
أَثَري	archaeological
أَجار	fee, rent, wages
إجازة	permit, holiday, leave, time off
إجباري	compulsory, obligatory
إجتِماع	meeting, society (sometimes)
إجتِماعي	social, sociable, friendly
إجر،إجرَين	foot, leg
إجْر،إجْرتَين،إِجرَيْن	leg
إجراء	holding, construction, carrying out
أُجرة،أُجور	salary, wages, rent, rental
أَجرودي	beardless, smooth-cheeked
إجرَين	two legs/feet
آجِلاً	delayed, lingering
إجلاء	evacuation
إجماع	unanimity
إجمال	whole, entirety, generality
إجمالاً	on the whole, generally, in general
أَجمَل	most/more beautiful
أَجنَبي،أَجانَب	foreign, foreigner
أجْنَبي،أجنَبيّة،أجانِب	stranger (person)
إجهاض	abortion
إجى ليكَحَّلهُ،عَماه	he came to eyeliner him, but he blinded him (he did him a misservice)
أَجير،أُجَراء	salaried worker, employee
إحباط،إحباطات	frustration
إحتِجاج	protest
إحتِجاجي	protest (adj)
إحتِرام	respect, honor
إحتِشام	modesty
إحتِقار	contempt, scorn
إحتِكار	monopoly
إحتِكاري	monopolous, monopoly (adj)
إحتِكاك	friction, contact
إحتِلال	occupation
إحتِمال	possibility, probability, likelihood
إحتِيات	spare, reserve, precaution
إحتِياتات	precautions
إحتِياتي	reserve, reserves
اِحْتِياط	precaution
أَحَد	one
أَحدَب،حَدباء،حُدُب	hunchback
إحدَعَش	eleven (when the number stands alone)
إحدَعشَر	eleven (before a noun, which is always in singular form)
أَحدَق	more/most clever, sharp
إحرام	the state of ritual consecration and abstention when performing hajj, or, the garment worn by men during the hajj
أَحرى	appropriate, worth
إحساس	feeling, emotion, sensation
إحساس،أحاسيس/إحساسات	feeling, emotion
إحسان	philanthropy, charity
أحْسَن	better
إحصاء،إحصائِيّات	counting, enumeration, census, statistic
أَحلى	more/most sweet, beautiful, nice
أحْمَر،حَمْرا،حُمُر	red
إحمِرار	blush, flush, reddening
أَحمى	more/most very hot, like iron or oil
أَحوَل،حولاء،حول	cross-eyed, person with a squint
أَحياناً	sometimes
أخ،أخْوة/إِخْوان	brother
أُخت،خَوات	sister
أُخْت،خْوات	sister
إختِبار	research, test, experiment
إختِراع	invention
إختِصاصي	specialist
إختِلاس	embezzlement
إختِلاف	difference, difference of opinion
إختِيار	choice (as a concept?)
آخَر	last
آخِر و أواخِر	end
آخَر،أُخرى	other, different, else
آخَر،أُخْرا،آخَرين	other
آخِر،أخرانِيّين	last
إخراج	direction, directing (on stage/screen)
أَخراني	last
آخرة	the hereafter, the last/ultimate
أَخرَس،خَرساء،خُرُس،خُرسان	dumb, unable to speak
أخْرَس،خَرْسا،خُرُس/خُرسان	dumb
آخِرِهِ	etcetera, etc
إخس!ء	shame! (how) horrible! ugh! what a bad smell!
أَخشَن	more/most coarse, rough, harsh
أَخَصّ	more/most special, extra special, especially
أَخِصّائي	specialist
أخْضَر،خضْرا،خُضُر	green
أخطَر	more/most dangerous
أَخطَر	more/most serious, important, grave
أَخَفّ	more/most light/slight
إخلاء	evacuation
إخلاص	faithfulness, loyalty, devotion
أَخلاق	morals, morality
أَخلاقي	moral (adj)
أَخمَل	thicker, thickest
أَخنَب،خَنباء،خُنُب	having a nasal voice, speaking through the nose
أَخنَف،خَنفى،خُنُف	having a nasal voice, speaking through the nose
إخوان	brethren, brotherhood
إخوة	brothers, male siblings
أَخير	last
أخير،أخيرة	last (adj)
أَخيراً	at last, finally
آداب	politeless, good manners, the humanities
آدار	March
إدارة	management, administration, direction
أَدَب،آداب	literature, politeness, good manners, social graces
أَدَبي	literary, moral
إدِّخار	saving
إدخال	insertion, putting in, inputting, input
أَدفى	more/most warm
أَدَقّ	more/most delicate, precise, accurate, meticulous, fine
إدمان	addiction
آدَمي،أَوادَم	polite, pleasant, nice, decent, humane
آدَمي،أوادِم	polite, decent, pleasant
أَدنى،دُنياء	lower, lowest, minimal, nearer, nearest
أَدَوات	tools, utensils, appliances
أَديب،أُدَباء	writer, author
أَديَق	more/most narrow
إذا	if
إذا/إزا	if
إذاعة	broadcast, broadcasting
إذْن	permission
إذَن/إذاً؟	so, then, consequently, therefore
إذنك معاك	excuse me (response)
إرادة	will, wish, desire
إران	Iran, Persia
إراني	Iranian, Persian
أُرُبّة	Europe
أَربَح	more/most profitable, lucrative
أرْبْعة	Wednesday
أرْبَعة،أرْبع،رابِع	four
أَربعينِيّة	centipede ("fortypede")
أُرُبّي	European
إرتِجال	improvisation, improvising
إرتِجالي	improvised
إرتِفاع	height, altitude, rise, ascent, increase
إرتِكاب	perpetrating, perpetration (VN)
إرتِياح	satisfaction, relief
أَرخى	more/most soft, slack, loose, flabby
أُردُن،الأُردُن	Jordan
أُردُني	Jordanian
أَرز	cedars
أَرزة	a cedar
أَرزَل	more/most despicable, contemptible, nasty, depraved
إرشاد	guidance, instruction
أرْض،أَرَاْضِي	earth
أَرضِشوكة	artichoke
أَرضي	terrestrial, land (adj), soil (adj), ground (adj)
أَرضِيّة	ground, floor, ground floor
أرغيلة،أَراغيل	argileh, water pipe
أَرفَع	more/most thin, slender, slim, narrow (usually round but not flat), high pitched
أَرَقّ	more/most thin, fine (of flat object)
آرمة،آرمات	sign (business, etc)
أَرمَل،أرامَل	widower
أَرمَلة	widow
إرهاب	intimidation, frightening, terrorism
إرهابي	terrorist
أَروَع	more/most wonderful, splendid, magnificent
إزا	if, whether
إزدِحام	crowding, overcrowding
إزدِهار	bloom, blooming, prosperity, boom
إزدِواجِيّة	duplication
أزْرق،زَرْقا،زُرُق	blue
إزعاج	annoyance, disturbance
أَزعَر،زَعراء،زُعران	lout, yob, no-good
أزْعَر،زُعْران	hooligan, crook
أَزكى	more/most smart, intelligent, clever, bright
إزَن،إزن،إذن	permission
إسّا	now, just now
أَساس،أُسُس	basis, foundation, basic knowledge rudiments
أَسباط	tribes (in the Bible)
إسبانيا	Spain
أَسبِرين	asprin
أَسبَقِيّة	precedence, priority, previous convictions
أُسبوع،أَسابيع	week
أُستاذ	teacher, lecturer, professor
أُسْتاذ،أَسَاتْذة	sir
أُسْتاذة،أَسَاتْذة	madam
إستأَصَل	removing, removal, uprooting
إستأَنَف	resumption, recommencement, renewal, appeal (legal)
إستِخبارات	intelligence (i.e. a body which gathers information (of military of political value))
إستِراحة	rest, intermission, break
أُسترالي	Australian
أُستراليا	Australia
إستِشهاد	quotation, martyrdom
إستِشهادي	relating to martyrdom or suicidal attacks
إستِطلاع	study, research, exploring, exploration
إستِعداد	readiness, willingness, preparedness, preparation
إستِعراض	review, parade
إستِعلام	enquiry
إستِعمار	imperialism, colonialism
إستِعماري	imperialist, colonialist
إستِعمال	use
إستِغلال	exploitation, taking advantage of
إستِفتاء	consultation, consulting
إستِفتاء	referendum
إستِفراغ	vomiting
إستِفزاز	provocation
إستِفزازي	provocative
إستِفهام	enquiry (desire to understand)
إستِقالة	resignation
إستِقبال	reception
إستِقرار	stability
إستِقلال	independence
إستِكمال	completion
إستِمرار	continuation, persistence
إستِنتاج	conclusion
إستِهلاك	consumption, wear and tear
إستِواء	evenness
إستيراد	importation, importing, import
إستيطان	settling, settlement, colonization
إستيعاب	absorption
أَسخَف	more/most stupid
أَسخَن	more/most warm, hot
أَسَد،أُسود	lion
أَسَر	captivity
إسراء	Mohammed's night journey where he flies on البراق to Jerusalem and hangs out with all the other prophets who came before him like Mary and Jesus and Moses
إسرائيل	Israel
إسرائيلي	Israeli
أُسرة،أُسَر	family
أَسرَع	fastest, faster
أُسَري	familial, relating to the family, family-
إسطِوانة	record (vynil)
اِسْطِوانة،اِسْطِوانات	music record
أُسطورة،أَساطير	legend, tale, fable
أُسطول،أَساطيل	fleet
إسعاف	[medical] care
أَسعَد	happier, happiest
آسَف	I'm sorry
أَسَف	sorrow, regret
آسِف،آسْفة،آسْفين	apologetic, regretful, sorry
أَسفَل،سُفلاء	lower, bottom, bottom part
إسفين،أَسافين	wedge
إسكان	housing
أُسكُت!ْ	shut up!
أَسكِدِنيا	loquat (that fruit thing)
إسلام	Islam, Muslims, surrendering, submission
أُسلوب،أَساليب	style, method
أُسُم،أَسامي	(other way to say) name
أَسمَج	ruder, rudest
أَسمَر،سَمراء،سُمُر	dark skinned, black
أَسْمَر،سَمرا،سُمُر	brown
أَسمَك	thicker, thickest (rare)
أَسمَن	more/most fat, plump (usually animals)
أَسَنسَير	elevator (from French)
إسهال	diarrea
أَسهَل	more/most easy, convenient
أَسواء	worse, worst, most evil
أسْوَد،سودا،سود	black
آسيا	Asia
أَسير،أُسَراء،أَسراء	prisoner, captive, POW
آسيَوي	Asian
إشارة	sign, signal, indication, badge, tag
إشاعة	spreading, rumor
إشباع	repletion, satisfaction
إشتِباك	complication, involvement, clash, skirmish
إشتِراك	participation, taking part, subscription, membership for
إشتِراكي	socialist
إشتِراكِيّة	socialism
إشتِياق	desire, longing, yearning
أَشَدّ	more/most intense, strong, powerful, forceful, severe, strict, harsh, tough
إشراف	supervision
إشراك	associating, polytheism
إشرَب هٰدا،بيرويك	drink this, it'll quench your thirst
أَشرَم،شَمراء،شُرُم	havine a cleft lip
أَشطَر	more/most smart, clever, bright, quick, hard working, successful
إشعار	notification, notice
أَشقَر،شَقراء،شُقُر	blonde
أَشكُرَك	thank you
أَشلَب	more/most beautiful, handsome, fine (weather)
أَشهَر	more/most famous, well-known
إشي	thing, anything, some
إشِي،شِي،إشْيا	thing
إصابة	injury, affliction, goal (sports?)
أُصبَع،أَصابَع/أَصابيع	finger, key (piano), tube
أُصْبَع،أصابِع\أصَابِيع	finger
أَصَحّ	more/most true, right, correct
إصدار	issuing
إصطَبل	stable (noun)
إصطِدام	clash, collision, crash
إصطِلاح	term (language)
أَصعَب	more/most difficult, hard
أصْفَر،صَفْرا،صُفْر	yello
أَصل،أُصول	foundation, origin, source, root
أصْل،أصول	foundation, root, source, origin
إصلاح	improvement, repair, reform
أَصلَح	more/most good, suitable, valid
أَصلَع،صَلعاء،صَلُع	bald
أَصلي	original, real, authentic, genuine
أصْليّة	original, authentic
أُصول،	rules, laws, procedures, fundamentals
أُصولي	abiding by (religious?) law, fundamentalist
أصولي،أصوليّين	fundamentalist
أُصولِيّين	the fundamentalists
أَصيل	noble, purebred, well bred, original, genuine, authentic
إضافة	addition, adding
إضافي	additional, extra
إضائة	lighting
أَضحى	sacrifice
إضراب	strike (labor)
إِضْراب،إِضْرابات	strike, refusal to work
إضطِراب	disturbance, unrest, riot
إضطِهاد	persecution
أُضفَر،أَضافَر	nail (of finger, toe, etc)
إطار،أُطُر	frame, context, framework
أَطرَش،طَرشاء،طُرُش	deaf
أَطرَش،طَرشاء،طُرش،طُرشان	deaf, deaf person
أُطروحة	dissertation, thesis
أَطرى	more/most soft
إطفاء	putting out, extinguishing
إطفائي،إطفائِيّة	fireman
اِطْفائي،اِتْفائيّة،اِتْفائيين	firefighter
إطِّلاع	being informed, awareness, knowledge, familiarity
إطلاق	freeing, releasing
أَطلَس	satin, atlas
أَطلَسي	Atlantic
أَطهَر	more/most pure
إعادة	returning, return, giving back, sending back
إعاقة	hindering, delaying, hinderance, obstacle
إعتِبار	consideration
إعتِداء	attack, hostile act, aggression, assault, trespass, trespassing
إعتِدال	moderation
إعتراف	confession, admission, recognition, acknowledgement
إعتِقاد	belief, opinion
إعتِقال	arrest, detention
إعتِماد	reliance, confidence, credit, loan
إعجاب	admiration
إعداد	preparation
إعدادي	preperatory
إعدام	annihilation, extermination, execution
إعراب	declaration, expression, inflection (gramm.), parsing
أَعرَج،عَرجاء،عُرِج	lame, limping
أَعرَف	knowing better, more expert
أَعَزّ	most dear, most precious, most beloved
أَعطَل	worst, nastiest
إعفاء	exemption
إعلام	information, notification
إعلامي	information (adj), informational
إعلان	announcement, statement, notice, advertizing, advertizement
أَعلَم	more/most knowing
أَعلى،عُلياء	higher, highest, upper
أَعمى،عَمياء،عُميان	blind
أَعمَى،عَميا،عُميان	blind
أَعنَد	most stubborn/opinionated
أَعوَج،عُوجاء،عُوج	crooked, bent, dishonest
أعوذُ بِالله	I seek God's refuge
أَعوَر،عُوراء،عُوران	one eyed, blind in one eye
إغتِصاب	rape, violation, robbery, usurpation
إغتِيال	assassination, murder
إغراء	temptation
إغزُست	exhaust (car)
إغلاق	closure
أغلَب	most
أَغلَبِيّة	majority
أَغمَق	more/most dark or deep
أُغنِية،أَغاني	song
أُغْنِيّة،أغاني	song
إفادة	benefit, use, advantage, evidence
آفة،آفات	epidemic, scourge, bane, evil, pest, disease (agriculture)
إفتِتاح	opening, inauguration
إفتِتاحي	opening, introductory, preliminary, prefatory
إفتِتاحِيّة/مَقال إفتِتاحي	editorial
إفتِخار	pride
إفتِقار	need, lack, shortage
أَفخَر	more/most glorious, luxorious, fancy, grand
أَفخَم	more/most luxury, splendid, magnificent, grand, fancy, classy
إفراج	release (from prison, custody)
إفراز	secretion
أفضَل	better, best, preferable
إفطار	first meal after sunset during Ramadan
إفطام	weaning, detoxification, detox, drying out (drugs/alcohol)
أَفعة،أَفاعي	adder, viper
أُفُق،أَفاق	horizon
أُفقي	horizontal
إفلاس	bankruptcy
أَفيَد	more/most useful, instructive, interesting
إقاع	rhythm
إقاف	stopping
إقامة	stay, sojourn, residence, residence permit
إقتِراح	suggestion, proposal
إقْتِراح،إقْتِراحات	suggestion, proposal
إقتِراع	voting
إقتِصاد	economy, economics
إقتِصادي	economic, economical, economist
أَقدَمِيَّة	seniority
إقرُنفُل	carnations, cloves
أَقسى/هَقسى	more/most hard, difficult, harsh
أَقصَر/هَقصَر	shorter/shortest
أَقصى	farther, farthest, most distant, maximal, maximum
أقطَع،قَطعاء	one-armed
أَقَلّ،هَقَلّ	least
أَقَلّ/هَقَّل	fewest, fewer
أَقَلِّيّة	minority
إقناع	persuasion, convincing
إقون	icon (i.e. religious painting)
أَقوى/هَقوى	stronger / strongest
أُقِيّة،أَواق	ounce (250gm in Jerusalem)
إكتِشاف	discovery, invention
إكتِفاء	contentment, satisfaction
إكتِئاب	depression
أَكِّدِنيا	loquat (that fruit)
إكرام	honor, honoring, respect, respecting
إكْرام الضْيوف	hospitality
أَكس	axle
أَكْل	meal
أَكلة	dish (particular type of food)
أكْلة،أكْلات	a [specific] food, a dish
أَكَمّ	several, a few, how many?
أكيد	certainly
أَكّيل	glutton
إلّا	if not, only, except, to (time), (and) there..., lo and behold
أَلّا وَكيلَك	everything'll be fine! (God is your guarantor)
أَلّا يوَفّقَك	Good luck! (may God cause you to succeed)
الأرض مَحروتة/مَحروثة	the land's been plowed
الإصلاح	the reformation
البَحرِيّة	the navy
آلة	machine, apparatus, instrument
آلِة،آلات	machine
التاني	the second (one)
التَحَرّي	the secret police
إلتِزام	commitment, obligation, undertaking
الْتَّمانينات	the eighties
إلتِهاب	inflammation
الجايْ	next
الجَبر	algebra
الجَزائَر	Algeria
الجِنسَين	both sexes
الجُوّاني	the inner tube (of tyre)
الجوزة	Adam's apple (and by extension the throat)
إلحاح	pressure, urging, imploring
إلحاد	atheism
الحق	fault
الحَمْدِ لله	Thank God
الخاصرتَين	the hips
الخَليل	Hebron (from Abraham's name)
الخَنافَس	The Beatles
الْرّاحَل	the deceased, the late
الْرّاديو مَفتوح	the radio's on
الرَجاء،عَدَم الْتَّدخين	no smoking please
الْرُّسُل	the Apostles
الْرَّسمالِيّة	capitalism
الْرَّملة	Ramleh (a town southeast of Jaffa)
الْرِّئَتيْن	the lungs
أَلَزّ،أَلَذّ	delicious, nice, pleasant, enjoyable
إلزامي	compulsory, obligatory
الْشّاهَد	the index finger
الْشّيعة	the Shi'a
الْشّيوعِيّة	communism
الْصَّحِّيّة	the national health service, government health services
الْصَليبِيّين	the crusaders
الضَوّ	light
العَفو	excuse me, pardon me, don't mention it, you're welcome
العيشة	lifestyle
إلغاء	cancellation, invalidation, abolition, abrogation
الفُتوحات	the conquests
الفَكَين	the jaws
أَلفِيّة	millenium
القاعِدة	al-Qaida
القَصَبة	the windpipe (anatomy)
القِيَم	values (beliefs etc)
الكُلّ	right away
اللاسامِيّة	antisemitism
الله يحْفَظ	God protect
الله يرْضَى عَلَى	May God be pleased with
الله يسَلْم	God save
الله يِوَفّي	God bless
اللوزتين	the tonsils
اللي فات،اللي فاتَت	previous (last)
أَلَم،آلام	pain, suffering
ألَم،ا	wound
المُأَخَّر	the second installment of the dowry
أَلماز	diamond
الماضْي،الماضية	past
المالِيّة	the treasury, ministry of finance
المُبتَدِئين	the beginners
المَبيضَين	the ovaries
المُتَدَيَّنين	the devout people
المُتَّهَم	the accused
المُجتَرّين	the ruminants (the type of animal a cow is)
المُختار	landlord
المُدَّعي	the claimant, plaintiff
المصَلَّبة	the Monastery of the Cross
المُعتَدي	the aggressor
المَلَكِيّين	the monarchists
المنافِع	toilet, washroom, lavatory
المَنكوبين	the catastrophized, the survivors (of war, disaster, etc)
النَطّة	leapfrog (child's game)
إلٰه،آلِهة	god
الهِند	India
الوارَث/الوارَت	the heir / inheritor
إلّي،إلّك	for me, for you
اِلّي/اِللي/يَلْلِي	the one, that, which, whom
اليَسارِيّين	the leftists, left-wingers
أَليف	familiar, domesticated
أَليم	painful, upsetting
أَليَن	more/most flexible
اليوم	today, these days
إمّ/أُمّ،إمَّيات/أُمَّهات	mother
إمّ\أُمّ	mother
أَمّا	but, on the other hand..., what a - ! how - !
إماء	sign, gesture
إمارة	emitate, principality
أمّاليوم	nowadays
أَمام	front, in front of, opposite
أَمامي	front (adj)
أَمان	security, safety
إمان	faith
أَمانة	loyalty, reliability, honesty, safety, security, object left for safe keeping, secretariat
أُمّة،أُمَم	nation, people, community
إمتِحان	test, exam
إمْتِحان،إمْتِحانات	exam
إمِتى	when
أَمر،أُمور	matter, issue
أَمر،أَوامَر	order, command
أمْر،أوامِر\أُمور	command, matter, issue
إمساك	constipation, the start of the Ramadan fast each day
إمضاء،إمضايات	signature, autograph
إمكان	possibility, power, capacity
إمكانِيّة	possibility, chance, opportunity, power, capacity
أَمَل،آمال	hope, prospect, chance
أَملَس	more/most smooth/straight
آمَن	safe, peaceful
أَمن	security, safety
أُمنِية،أَماني	wish, desire, longing, dream
أَمهَر	more/more skillful, skilled, expert
أُمّي	illiterate
أُمِّيّة	illiteracy
إن	if - always followed by past tense verb, even if it refers to the future
إن شَالله	God willing
أَنا وعيت	I woke up
أَناقة	elegance
أَناني	egotistical, egoist
أَنانِيّة	egoism
أُنبوب/أُنبوبة،أَنابيب	pipe, pipeline, tube, test tube
إنتاج	production, output
إنتِباه	attention, attentiveness, alertness, care, caution
إنتِحار	suicide
إنتِخاب	election, voting
اِنْتِخاب،اِنْتِخابات	election
إنتِداب	deputation, mandate (over a territory)
إنتِصار،إنتِصارات	victory
إنتِظار	waiting (VN)
إنتِظام	order, regularity
إنتِفاضة	shaking oneself, stirring onself, awakening, intifada, revolution
إنتِقاد	criticism
إنتِقام	revenge, vengance
إنتِقامِيّة	vengeful, retaliatory
إنتِماء	belonging, affiliation, membership
إنتِهازي	opportunist
إنتِهازِيّة	opportunism
إنتِهاك،إنتِهاكات	violation
أَنتَين	antenna, aerial
أُنثى،أَناثي/أَنتى،أَناتي	female (animal)
إنجاز	achievement, accomplishment
إنجاص	pear
إنجِذاب	attraction
أَنجَق	hardly, scarcely, barely
إنجيل،أَناجيل	(the) Gospel
أَنحاء	sections, parts
إنحِراف	deviation, perversion, corruption
إنحِياز	partiality, bias
إنخِفاض	drop, decrease, reduction
إندِماج	integration, fitting in
إنذار	warning, notice
إنسان،ناس	human being, person, people
إنساني	human, humane
إنسانِيّة	humanity, humaneness
أنسَب	more/most suitable, appropriate, proper
آنِسة	young lady, miss
إنسِجام	harmony, fitting in, integration
إنسِحاب	retreat, withdrawal
إنشاء	essay
أَنشَط	more/most active, energetic, animated, vivacious, full of life
أَنشَف	most dry
إنشِقاق	splitting, schism
إنصاف	justice, fairness
أَنصَح	fattest, plumpest
إنضِباط	discipline, self-control
أَنضَف	cleaner, cleanest
إنضِمام	joining, enrollment
إنطِباع	impression
إنطِلاق	release, eruption, bursting out, departure, start, starting point
إنعِكاس	reflection
إنغَلترا	England
إنغليزي،إنغليز	English
إنفِجار	explosion
إنفِراد	isolation, exclusion
أَنفُس	selves
إنفِصال	separation
إنفِصام	splitting, split
إنفِعال	excitement, agitation
إنفلُوَنزا	flu, influenza
إنقاذ	saving, rescuing, rescue
إنقِلاب	upheaval, revolution, coup
أَنمَش،نَمشاء،نُمُش	freckled, having freckles
إنها	that she...
إنهاء	ending, termination
إنهِيار	collapse
أَنو،أَني	which?
إنّو\إنّ	that
أَنيق	elegant
إهانة	insult, humiliation, disdain, contempt
أَهبَل،هَبلاء،هُبُل،هَبالا	fool, idiot, stupid person
إهتِمام	interest, concern, attention
اِهْتِمام،اِهْتِمامات	interest, concern, attention
أَهدى	more/most calm, quiet
أهلا بيك	welcome (reply)
أهْلا و سَهْلا	welcome
أَهلي	domestic, local
إهمال	neglect
أَهمَل	more/most badly behaved, lout, yob, hooligan
أَهَمِّيّة	importance
أَهوَن	easier, easiest
أوْ	or
بِالأَصَحّ	or more precisely,
أَواعي	clothes
أَوان	time
أُوتَيل	hotel
أودغَيم	mumps
أَوسَط،وَسطى	middle, central
أَوسَع	more/most wide, spacious, comprehensive
أُوضة،أُوَض	room
أَوضَح	more/most clear, clearer, clearest
اَوطى	more/most low (in all senses), base, inferior, coarse, immoral
أْوعى!/أْوعي!ء	look out! be careful!
أوّلًا	firstly
أَوَّلاني	first
أَولَوِيّة	precedence, right of way
أَوَنطة	trickery, swindle
أيّ،أَيّا	which
أيّا واحَد	which one
أَيّار	May
إئتِلاف	coalition
إيجابي	positive, affirmative
إيد،إيدَين/أَيدي،إيدتَين	hand, arm, handle
إِيْد\إيْدي،إيدتين،إِيْدين	hand
أْيدز	AIDS
أْيش	what?
إيطالي	Italian
إيطاليا	Italy
أْيلول	September
أْيمتى	when?
باب،أبْواب	door
بابور،بَوابير	ship (from French)
باخِرة،بَواخَر	ship
بارَد	cold, unemotional, sluggish
بارَز	protruding, prominent, obvious
بارود	gunpowder
بارودة	rifle
باريز	Paris
باز،بيزان	falcon
باسور،بَواسير	piles, haemorrhoids
باص،باصات	bus
باطَل	futile, vain, false, unfounded
باطِني	internal
باطيئ،باطيئة	slow
باقي	remaining, rest, remainder, change (money)
باقي،باقية،بايقين	remainder
بال	mind
بِالْتّأَكيد	certainly, definitely
بِالْتّالي	hence, therefore, in consequence
بالْتَّدريج	gradually
بالْتَّدقيق	accurately, precisely
بالْتَّساوي	equally, in equal measure
بِالْتَّسَلسُل	in (proper) sequence
بِالْتَّناوُب	in rotation in shifts, in turn
بِالْزّات	in particular, none other than, of all people/things/places
بِالْصُّدفة	by chance
بِالضَبْط	exactly
بِالْظَّبط	exactly, precisely
بِالْظَّلط	naked, nude
بِالعَرض	across, breadthwise
بالعَكس	on the contrary
بالَغ،بالغة،بالِغين	adult, grown up
بِالقُرعة	by drawing of lots
بالقَصد/قَصداً	on purpose, deliberately, intentionally
بالكاد	hardly
بِالكَد	scarcely, hardly, barely, no sooner...
بِالمَرَّة	completely
بِالمَرّة	[not] at all
بامية	okra
باهَت،باهتة	pale, faded
بايَخ،بايخة	faded, tasteless, insipid, uninteresting, lame
بَبَّغة،بَبَّغَوات	parrot
بُبو	baby, pupil (eye)
بَبوج	slippers
بَبونَج	camomile (tea)
بِتراهَنني؟	you wanna bet me?
بَتِنجان	eggplants
بِتنيه	I fold it
بِجوز	perhaps, possibly
بَحّار،بَحّاراء	sailor, seaman
بَحبوحة	prosperity, ease, comfort
بَحت	pure, unmixed, purely
بَحث،بَحس،أَبحاث،أَبحاس،بُحوث،بُحوس	research, examination
بَحر،أَبحار،بُحور	sea, during, in the course of
بَحري	marine, martime, sea- (adj)
بُحَيرة	lake
بُخار	steam
بِخاطْرك	with your permission
بَخت	luck
بِخصوص	concerning, regarding
بُخل	meanness, stingyness
بَخور	incense
بَخيل،بَخيلة،بُخَلاء	mean, stingy, miser
بُدّ	way out, escape
بَدال ما	instead of
بَدال،بَدَل	instead of
بِداية	beginning
بِدائي	primitive
بَدَر	full moon
بَدري	early
بَدلة	suit (of clothes)
بَدَن	body
بِدون شَكّ/بَلا شَكّ	without doubt
بَديل	substitute, alternative
بِذر،بِزر	seeds
بِذرة،بِزرة	a seed
بَرّا	outside
بَرائة	innocence
بَرّاد	fridge
بَرّادة	refrigerator
براق،البُراق	name of the mount which carried Mohammed on his Night Journey
بَرّاني	external, outside
بَرّاية	pencil sharpener
بَربور،بَرابير	snot
بَرّة،بَرّات	outside
بُرتُقال	Portugal
بُرج،أَبراج	tower, zodiac sign, birth sign
بَرد	cold
بَرْد	cold
بَردان	cold
بُردَاي/بُردَايِة،بَرَادي	curtain
بُرداية،بَرادي	curtain
بُردقان،بُرتُقال	oranges
بِرْدْقانِي	orange (color)
بَرَزان	bugle
بَرَص	leprosy
بَرضو	also, too, as well, nevertheless, however, still
بَرطيل،بَراطيل	bribe
بُرعُم،بَراعَم	bud
بُرغُل	bulgur wheat, cracked wheat
بَرغوت،بَراغيت	flea
بُرغي،بَراغي	screw
بَرق	lightning
بُرقُع	veil
بَرقوق	plums
بَرقِيّة	telegram
بُركان،بُراكين	volcano
بَرَكة	blessing
بِركة،بُرَك،بِرَك	pool, puddle
بُرما	a type of pastry
بَرمَجة	(computer) programming
بَرميل،بَراميل	barrel, cask, drum
بُرهان،بَراهين	proof, evidence
بُرواز،بَراويز	frame, picture frame, window frame, etc
برودة	coldness
بروفة	rehearsal, fitting
بَروقة	wig (from italian)
برومية	plums
بَرّي	wild, undomesticated
بَرِّيّة	(uninhabited) countryside, the wilds
بَرّيت	outside (preposition)
بَريد	post, mail
بريز	(electrical) plug, (electrical) socket (from french)
بريشت	soft boiled (egg)
بريق،أَباريق	jug, pitcher, teapot, watering can
بْريق،أباريق	jug, pitcher
برَيك	brake
بَرّيمة	corkscrew
بَريئ،بَريئة	innocent
بِز،بزاز	breast, nipple, teat, mouthpiece
بزاق	saliva
بَزّاقة	slug
بَزَلّا	peas (from italian)
بُزَّيق	slug
بزيم،أَبازيم	buckle
بَس	but, only, just
بِسّ،بِسّة،بساس	cat
بِسّ،بِسّة،بِسّات	cat
بساط،بُسُط	basic carpet or rug
بْساط،بُسُط	carpet, rug
بَسبُرت	passport
بُستان،بَساتين	orchard, vegetable garden, kindergarten
بُستان،بَساتين	orchard
بُستران	protestants
بِستون،بَساتَن	piston
بَستوني	spades (playing cards)
بْسُرعة	quickly
بَسطة	stall (in a market etc)
بَسيط	simple, small, insignificant, small quantity
بَسيط،بَسِيطين	simple
بَسيطة	insignifcant, no big deal
بُشار	popcorn
بِشارة	good news, gospel
بَشَر	human being
بَشَرة	complexion
بُشرة	good news
بَشَري	human (adj)
بَشَرِيّة	humankind
بِشَع	ugly
بَشكير	towel
بَصّار،بَصّارة،بَصّارين،بَصّارات	fortune teller, seer
بَصَر	sight
بَصَل	onions
بَصَلة	an onion
بَصمة	fingerprint
بَصير	clear sighted, far sighted, one of God's names
بَصيص	glimmer, glow
بضاعة،بَضايَع،بَضائَع	merchandise, goods
بَضغَط/بِكبَس عَلى أَيكُن،بتِتكَبَّر	I click on an icon and it gets bigger
بَطّ	ducks
بِطاقة	card, ticket, label
بَطالة	unemployment
بطانة	lining (of a garment)
بَطّانِيّة	blanket
بَطّة	a duck
بَطرَك،بَطاركة	patriarch
بَطرُن	pimp
بَطَّل	worthless, unimportant
بَطَل،أَبطال	hero, champion
بَطن،بطون	belly, stomach, abdomen
بَطَن،بُطون	stomach
بُطولة	heroism
بَطون	concrete (?)
بُطُئ	slowness
بَطّيخ	watermelons
بَطّيخة	a watermelon
بُعُد	distance, dimension, aspect
بَعْد الضُهْر	afternoon
بَعْدين	afterward
بَعَر	droppings, dung
بَعزَق/بَعزَقجي	he wasted / wasteful, spendthrift
بَعسة/بَعثة	delegation, deputation
بَعشة	unpleasantness, frustration, disappointment, difficulty
بَعْض	other
بَقاء	survival, existence
بَقّال،بَقّالين	grocer
بَقّال،بَقَّالة\بَقّالين	grocer, grocery store
بَقالة	grocery/groceries
بَقبوشة،بَقابيش	blister
بُقجة،بُقَج	bundle
بَقدونَس	parsely
بَقَرة،بَقَر	cattle, cows
بَقَرة،بَقَر\بَقَرات	cow
بُقعة،بُقَع	stain, puddle, patch, blot
بقول	edible plants
بَقِيّة	remainder, rest, remnant
بِكار،بِكارات،بِياكير	compasses, a pair of compasses (for drawing a circle)
بَكارة	virginity
بُكة،بِكة	crying
بِكر	firstborn, eldest, virgin
بُكرة	tomorrow
بَكَرة	reel (of film, tape), spool, bobbin (of thread), coil
بُكْرة	tomorrow
بُكس	punch (fist)
بُكس،بُكسة،بُكسات،بكوسة	box, crate
بُكْسة،بُكاس	box
بِكَفّي	enough
بَكَكس،بَكَكسات	rear axle (from english)
بَكورة،بَواكير	pulley
بَكّير	early
بَكّير\مْبَكِّر،بَكّيرة\مْبَكِّرة،مْبَكِّرين	early
بَلا	without
بَلا،بِدون	without
بَلاش	nothing, free (no cost), nevermind
بَلاش	don't
بَلَّاط،بَلَّاطة،بَلَّاطين	tiler, flooring-tile-layer
بَلاطة،بَلاطات،بَلاط	tile(s)
بَلاغة	eloquence, rhetoric
بُلبُل،بَلابَل	nightingale, spinning top, fluent
بَلَة	moistening, wetting
بَلجيكا	Belgium
بَلَح	dates
بَلَد،بْلاد	country
بَلَد،بُلدان\بْلاد	country
بَلَدي	local, traditional
بَلَديّة،بَلَديّات	municipality
بَلغَم	phlegm
بَلكون،بَلَكين،بَلكونات	balcony
بَلكي	perhaps
بَلكي،بَلكَن	maybe
بُلَندا،بُلونيا	poland
بَلّوط	oak(s), acorn(s)
بَلّوعة	drain, drainpipe, sewer
بَلون،بَلالين	balloon, large round or cylinder container, bubble
بِلّي	in what, with what
بُليصة،بَوالَص	(insurance) policy
بَلّيط،بَلّيطاء	tiler, flooring-tile-layer
بَليغ،بَليغة،بُلَغاء	eloquent
بِنّ،بَنّ،بُنّ	coffee beans, ground coffee
بَنّا،بَنّاي	builder
بَنّاء،بَنّاءة	constructive
بنادمين	human beings, people
بنْت،بَنات	daughter
بِنت/إِبن وَحيد	only child
بِنتيْنَك	your two girls (wrong)
بَنج	anasthetic, narcotic
بَنجَر	beetroot
بَند،بُنود	paragraph, clause
بُندُق	hazelnuts
بَندوق،بَناديق	bastard, illegitimate child
بُنصُر	ring finger
بَنصَر،بُنصُر	ring finger
بَنْضورة،بَنْضَورات	tomato
بَنْطَلون،بَنطَلونات	pants
بَنَفسَجة،بَنَفسَج	violet (flower)
بَنَفسَجي	purple
بَنَفسَجي،عِنّابي	purple
بَنك،بنوك	bench, bank
بَنّورة،بَنانير	marble
بُنى	building, constructing
بَنّى،بَنّاي	builder
بِنّي	brown
بهار	spice
بَهائي	Bahai
بَهجة	splendour, glamour
بَهدَلة	humiliation, abuse
بَهلَوان،بَهلَوانِيّة،بَهلَوانات	acrobat, tightrope walker
بَهلَوانِيّات	acrobatics, acrobatic stunts
بَوّاب،بَوّابين	doorman, gatekeeper
بَوّابة،بَوّابات	gate, large door, double door
بِوافقَك	I agree with you
بوجِيّة	spark plug (from french)
بودرة	powder
بوز	muzzle, snout
بُوسة	kiss
بوسطة	post, mail, post office
بوسطَجي	postman
بوصَلة	compass
بوط	boots (high boots with laces)
بوظة	ice cream
بوفَيه	snack bar, dresser
بوق،أَبواق	trumpet
بَول	urine
بُول	stamp(s)
بولَيت	ticket
بومة،بوم	owl
بوية	shoe polish, paint, paintwork
بويَجي	shoe shiner
بُوَيضة	egg, ovum, ovule
بَياض	white (noun), whiteness, sheep
بَيّاع،بَيّاعين	salesman, merchant, dealer
بيّاع،بيّاعين	seller, salesperson, vendor
بَيان،بَيانات	announcement, communique, declaration
بيانو،بيانُوات،بيانُوات	piano
بَياني	explanitory, illustrative
بَيت،أَبيات	verse
بيت،بُيوت	house, home
بيِتعابَطوا	they hug each other, they embrace
بير،بيار،بيارا	well, cistern
بيرة	beer
بيرعاك؟	are you itchy? (does it itch you)
بَيضة،بَيض،بَيضات	egg, testicle
بيضة،بيض	egg
بَيطَري،طَبيب بَيطَري	vet
بيع	sale, selling
بيعاديني	he's hostile to me
بَيعة،بَيعات	transaction, deal
بيِكفَر وُجود الّا	he doesn't believe in God
بين	between
بيئة	environment, surroundings
تابَع	following
تابَع،أَتباع	follower
تابوت،تَوابيت	coffin, casket, the arc of the covenant
تأَبين	eulogy, commemoration
تَأَتأَئَ	stammer, stutter
تَأَثُّر	impression, influence
تأَثير	effect, influence, impression
تَأْثِير،تَأْثِيرَات	effect, influence, impression
تاج،تيجان	crown, pip (insignia of military rank on the shoulder of an officer's uniform)
تاجَر،تُجّار	trader, dealer, merchant
تاجِر،تاجْرة،تُجّار	trader, dealer, merchant
تأَجيل	delay, postponement, deferment
تأَحيل	training, rehabilitation
تأَخير	lateness, tardiness, delay
تاريخ	history
تاريخ،تَواريخ	date, history
تاريخي	historical, historic
تازا/طازا	fresh (masc or fem)
تاسَع	ninth
تأَسيس	founding, foundation, establishment
تأَشيرة	visa
تافَه/تافهة	trivial, worthless
تأَكيد	confirmation, assurance
تالَت/تلاتة	third
تالولة،تَواليل	corn (thickened skin on the foot)
تالي	next, following, subsequent
تأَليف	compisition, writing
تامّ	perfect, complete, total
تَأَمُّل	contemplation, meditation, consideration, reflection
تامَن	eighth
تأَميم	nationalizaton
تأَمين	insurance
تَأَنّي	slowness, deliberateness
تاني	second, another, other, different, else
تانِيًا	secondly
تَبادُل	exchange, substitute, swap
تَباطو	slowing down, liesureliness
تباوَسوا	they kissed each other
تَبجيل	respecting, praising
تَبَخُّر	evaporation
تَبخير	censing, burning incense
تَبَرُّع	volunteering, contribution, donation
تَبسيمة،تَباشيم	rivet, stud
تَبشير	evangelism, missionary activity
تَبَع	belonging to, of
تَبَع\تاع	of, belonging to
تَبَعِيّة	dependence
تَبليغ	[official] announcement, notification
تِبَن	straw
تَبَنّي	adoption
تَبويل	urination
تَتخيطة	loft, attic
تَتَوُّع	voluntering
تَتَوُّعي	voluntary
تَتويج	crowning, coronation
تَثبيت	consolidation, stabilization, tenure
تِجاه	toward, towards
تَجاوُب	response (positive reaction)
تَجديد	renewal, innovation
تَجرِبة،تَجارِب	experiment, attempt, experience, trial, test
تَجرِبِة،تَجارِب،مُحاولة،مْحاوَلات	attempt
تَجَسُّس	espionage, spying
تَجعيد،تَجاعيد	wrinkle
تَجفيف	drying
تَجليدة،تَجاليد	cover (of book)
تَجَمُّع	assembling, gathering, collection, concentration
تَجميد	freeze
تَجميع	assembling, gathering
تَجميل	beautifying, beautification, cosmetics
تَجميلي	cosmetic
تَجنيد	enlistment, mobilization, recruitment
تَجَوُّل	touring, roaming, walking about
تَجويد	reading (from the Qur'an (according to established rules of pronounciation and intonation))
تَجويف،تَجاويف	hollow, cavity
تَحت	below
تَحَت/تَحت	below, under, beneath, underneath, downstairs
تَحتاني	lower, bottom
تَحَدّي	challenge, dare
تَحديد	defining, definition, limitation, limit, restriction
تَحَرّي	(undercover) police investigation, secret police
تَحرير	release, liberation, editing, editorial board
تَحَسُّن	(the undergoing of) improvement
تَحسين	(the causing of) improvement
تَحضير	preparation
تُحفة،تُحَف	rare/valuable object, museum piece
تَحَفُّظ	wariness, caution, reservation(s), misgiving(s)
تَحقيق	realization, implementation, fulfilment, accomplishment, carrying out, putting into practice, investigation, interrogation, lit. making something true / finding the truth
تَحَكُّم	control, dominion
تَحكيم	arbitration
تَحلِيّة	sweetening
تَحليل	analysis
تَحميل	charging, loading
تَحميلة،تَحاميل	suppository
تَحنيط	taxidermy, stuffing
تَحَوُّل	transformation, change
تَحِيّة	greetings, regards, best wishes
تَحَيُّز	partiality, bias, taking sides
تَخَت،تخوت/تخوتة	bed
تَخَرُّج	graduation
تَخريب	destruction, sabotage
تَخزين	storage (computer), storing
تَخَصُّص	specialization
تَخطيط	planning, drawing, sketching
تَخفيض	reduction
تَخفيف	lightening, easing, reduction, relief
تَخلاي	dessert, sweet, pudding (sweetening)
تَخَلُّف	backwardness, retardation
تَخليد	perpetuation, immortalization
تُخْن،تُخْنة	thickness (round and long)
تُخُن/تُخَن	thickness, diameter, gauge
تَخويت،تَخويتات	nonsense, rubbish
تَخويف	intimidation, terrorization
تَخَيُّل	imagining, illusion, fancy
تَخَيُّلات	imaginings
تخين،تخان	thick (esp. elongated tubular objects)
تْخين،تْخينة،تْخان	thick (round & long)
تَدبير،تَدابير	arrangement
تَدَخُّل	interference, meddling
تَدخين	smoking
تَدريب	training, drilling
تَدريج	graduation, gradualness
تَدريس	teaching
تَدريعة	burping, belching
تِدشاية	belching
تَدفِئة	heating
تَدقيق	accuracy, precision, meticulousness
تَدنيس	desecration
تَدَهوُر	deterioration
تَدويل	internationalization
تراب	earth, soil, dirt, dust
تَراجُع	withdrawal, retreat
تَراويح	special prayers said after the evening prayer in Ramadan
تِرباية	bringing up children, upbringing, education (of children within family), breeding
تُربة	soil, earth, dirt, cemetery
تَربَوي	educational
تَربِية	education
تَرْبِية،تِرْباي\تِرباية	upbringing
تَربيعة،تَرابيع	check (in a pattern)
تَرتيب	order
تَرتيل،تَراتيل	chanting, hymn-singing, a style of Qur'anic recital
تُرجمان	interpreter
تَرجَمة	translation
تَرخيص	authorization, licensing, reduction (in price)
تَرَدُّد	hesitation
تِرس،تروس	shield
تَرشيح	canditature, candidac
تَرضِية	compensation, consolation
تَرَف	luxury, affluence
تَرفيه	recreation, entertainment, fun
تَرفيهي	recreational, entertaining, fun
تِرقاية/تَرقِية	promotion
تَرك	leaving (vn)
ترَكّ	truck
تَركة/تِركة	legacy, bequest, inheritance
تَرَكني	he left me
تُركي،أَتراك	Turkish, Turk
تَركيب	assembling, assembly, putting together, composition, make-up, grafting, graft (plants)
تَرْكيب،تَرْكيبات	assembly
تَركيبة،تَراكيب	graft, scion, tall story
تَركيز	concentration
تُرى،يا تُرى	I wonder..
ترَيّا	chandelier
تَريدي	abstract
تريْن	train (from english)
تَزكار	memento, memory
تَزَلُّج	skiing
تَزوير	forgery, counterfeiting, falsification
تَزييت	oiling, greasing
تَسالي	roasted seeds/nuts
تَسامُح	tolerance, forbearance
تَساهُل	lenience, flexibility, forbearance
تَساوي	equality, parity
تَسآئُل	questioning, question, query
تَسجيل	registration, recording
تَسْجيل،تَسْجيلات	registration, recording
تَسريح،تَساريح	demobilization, discharge, permit, authorization, license, combing, hairstyling
تُسُع،تساع	a ninth
تِسْعة،تِسْع،تاسِع	nine
تَسعيرة	price list
تَسكة	stretcher (some areas)
تَسكير	closing, closure
تِسلَاي/تِسلَاية	amusement, entertainment, fun, a good time, pastime
تِسْلاية	fun, entertainment
تَسَلُّح	armament, arming oneself
تَسَلسُل	sequence, series, succession
تَسلِية	amusement, fun
تَسليح	arming, armament
تَسليم	handing over, delivery
تَسْليم،تَسْليمات	delivery
تَسَمُّم	poisoning
تَسميع	letting someone hear, hint, allusion, clue
تَشابُه	similarity, resemblance, likeness
تَشآئُم	pessimism, superstitious fear, fear of bad luck
تَشَّتُت	dispersion, scattering
تَشتيت	scattering, dispersal (the causing of scattering)
تَشجيع	encouragement
تَشخيص	diagnosis
تَشديد	strengthening, intensification, adding a shadda
تَشريح	slicing, cutting into slices, dissection, anatomy, autopsy, post-mortem examination
تَشغيل	employing, operating
تَشكيل	forming, formation, vocalization, vowelization
تَشكيلة	range, variety
تَشَنُّج	cramp, crick
تشوك	choke (car)
تَشَوُّه	deformity
تَشويش	confusion, interference
تَشويه	distorting, distortion
تَصادُم	crash, clash, impact, collision
تَصدير	exportation, export
تَصديق	[official] approval, confirmation
تَصَرُّف	behaviour, demeanour, disposal
تَصريح،تَصاريح	statement, announcement, declaration, permit, authorization, license
تَصريف	marketing
تَصعيد	escalation
تَصفِية	liquidation, clearance, selling off (business)
تَصَلُّب	hardening, becoming hard
تَصليح	repairing, repair
تَصميم	decision, determination, planning, designing, design
تَصنيف	sorting, grading, classification, categorization
تَصويت	voting, vote
تَصوير	photographing, photography, drawing, sketching, painting
تَضارُب	contradiction, conflict
تَضامُن	solidarity
تَضَخُّم	swelling, distension, inflation
تَطبيق	application, implementation
تَطَرُّف	extremism
تَطريز	embroidery
تطَعَّم،بيِتطَعَّم	o get vaccinated, get inoculated
تَطعيم	inoculation, vaccination, immunization
تَطَلُّع	striving, aspiration, ambition
تَطليعة	look, glance
تَطهير	purification, disinfection
تَطَوُّر	development, the undergoing of development
تَطوير	development, the causing of development
تَع/تَعي/تَعو	come here, come on
تَعادُل	equality, draw (sports/games)
تَعال	come
تعال/تعالي/تعالوا	come / come here / come on (long)
تَعامُل	commerce, transaction, dealing, treatment, behaviour (towards others)
تَعاوُن	cooperation, mutual aid
تَعايُش	coexistence
تَعَب،أَتاب	tiredness, weariness, tiresome task, effort, bother, nuisance, trouble, fees (in plural)
تَعبان	tired, exhausted, euphemism for unwell/sick
تَعبان،تَعبانة،تَعبانين	tired
تَعبير،تَعابير	utterance, expression
تَعتير	misfortune
تَعَجُّب	wonder, amazement, astonishment
تَعَدُّد	pluality, multiplicity, proliferation
تَعديل	modification, amendment
تَعَرُّف	acquaintance
تَعريب	sorting
تَعريف	introduction (of people), making a noun definite (gram)
تَعريفة	price list, tariff, half a jordanian piastre
تَعزيب	torture
تَعزِيّة	consolation, condolence, comfort
تَعزيز	strengthening
تَعزيل	cleaning out, cleanup, clearing, clearout
تَعَصُّب	extremism, fanaticism
تَعَطُّش	thirst, longing
تَعقيد	complication, complexity
تَعلَب	fox
تَعليق	hanging, suspending, sticking, commentary, comment, remark
تَعليقة،تَعاليق	hook, hanger
تَعليل	reason, justification
تَعليلة	pre-wedding evening of singing and dancing for a bridegroom
تَعليم	teaching, education, instruction, direction, directive
تَعميم	generalization, circular (letter)
تَعَهُّد	commitment, obligation, undertaking, promise
تِعواية	barking
تَعويد	compensation
تَعْويض،تَعْويضات	compensation
تَعيس،تُعَساء	miserable, unhappy, wretched
تَعيين	appointment, nomination
تَغريد	birdsong
تَغزِيّة	nutrition
تَغَيُّب	absence
تَغَيُّر	(the undergoing of) change
تَغيير	(the causing of) change
تُفّاحة،تُفّاح	apple(s)
تَفاهُم	(mutual) understanding
تَفائُل	optimism
تَفتيش	looking for, scrutiny, inspection, search
تَفخيم	emphatic pronounciation (of a consonant in Arabic)
تَفسير	interpretation, explanation, elucidation, commentary
تَفصيل،تَفاصيل	detail, cutting (tailoring and dressmaking)
تَفْصيل،تَفْصيلات	detail
تْفَضَّل	here you go
تَفَقُّد	parade, inspection
تَفكير	thought, thinking
تِفَل	coffee grounds
تَفَهُّم	understanding, insight, comprehension
تَفَوُّق	excellence, superiority, supremacy
تَفويض	authorization, authority
تَقا‘ُد	retirement
تَقَدُّم	advance, progress
تَقَدُّمي	progressive, advanced
تَقدير	estimate, appraisal, assessment, appreciation
تَقريب	bringing together, bringing nearer
تَقْريب،تَقْريبات	bringing closer
تَقريباً	nearly, almost, about, approximately, round about
تَقرير،تَقارير	report, deciding, taking a decision
تَقسيط/تَقصيط	payment in instalments, hire purchase
تَقسيم	dividing, division, partision
تَقَشُّف	ascetism
تَقصير	shortening, abridgement, negligence
تُقَل	weight
تُقلة	burden
تَقليد،تَقاليد	tradition, custom, imitation, copy
تَقليدي	traditional
تَقليص	reduction
تَقليل	reduction, decrease
تَقَمُّص	transmigration of souls, reincarnation
تَقويم	calendar
تَقيرة	neckline, neck (garment)
تقيل،تقال	heavy
تْقيل،تْقيلة،تْقال	heavy
تَكاثُر	increase, growth
تَكَتُّل	consolidation, unity, solidarity
تَكتيك	tactic, tactics
تَكرار	repetition
تِكْرَم	I'll be honored!
تَكرير	refinement
تَكريم	respect
تَكسير	shattering, smashing, breaking up, pain, aches
تَكليف،تَكاليف	cost, expenditure, formality, standing on ceremony, social niceties
تَكْليف،تَكاليف	formality, etiquette
تَكَهُّن	supposition, guess, guesswork
تَكوين	forming, creation, formulation
تَكَيُّف	(the undergoing of) adjustment, adaptation
تَكييف	adjustment, regulation, adaptation
تَلّ/تَلّة،تلال	hill, mound
تَلا	near, close
تَلاتة،يوم الْتَّلاتة	Tuesday
تَلاتة،تَلات،تالِت	three
تلاتَتنا	the three of us / we three
تَلّاجة	fridge, refrigerator
تَلّاجة،تَلّاجات	refrigerator
تَلاعُب	cheating, funny business, hanky panky
تلاقيْنا	we('ve) met
تِلاوة	reading aloud
تَلَبُّك	confusion
تَلبِيّة	response, compliance
تُلت،تلات	a third, twenty minutes (third of an hour)
تَلَتَّعَش	thirteen
تُلتيْن	two thirds
تَلَج	snow, ice
تَلحَمي،تَلاحمة	native / resident of Bethlehem
تَلخيص	summary, summing up
تَلفِزيون	television, TV
تَلفِزيوني	TV-related
تَلَفون	phone, telephone, phonecall
تَلَفوني	telephone-related, telephonic
تَلفيق	fabrication, trumped up story
تِلقائي	spontaneous, automatic
تِلقائيّاً	spontaneously, automatically
تِلموز،تَلاميز	student, trainee, apprentice
تَلميح	hint
تَلميح،تَلاميح	hint, clue
تِلميِز،تِلميِزة،تَلامِز	pupil
تَلويث	pollution
تَلوين	coloring
تَلوين،تَلاوين،قَلَم تَلوين	colored pencil
تَليين	softening, making supple
تُمّ	mouth
تُمّ/تَمّ،تمام	mouth
تَمام	exactly, precisely, completely, fine
تَمانية،تَمان،تامِن	eight
تُمباك	tobacco (for arghile)
تَمبَل/تَنبَل،تَمابَل/تَنابَل	lazy (from Turkish)
تَمبَن/تَمبُن،تَمبَنز	tampon, tampax (from english)
تَمثيل/تَمسيل	presentation, performance, show, acting, dramatic art, representation, representing
تَمثيلِيّة،تَمسيلِيّة	show, performance, play
تَمخيخ	brainwashing
تَمَدُّد	expansion
تَمَر	dried dates (coll)
تَمَرُّد	rebellion, revolt
تَمريض	nursing
تَمرين	pratice
تَمرين،تَمارين	practice, excersize, drill
تَمَسُّك	adherence, holding on to, sticking to
تَمسيح،تَماسيح	crocodile
تَمسيل صامَت	mime, pantomime (silent acting)
تَمليق	flattery
تَمَن،أَتمان	value, price, cost
تَمَن،أتْمان	price, value
تُمن/تُمُن/تُمَن،أَتمان/تمان	an eighth
تَمَنتَعَش	eighteen
تَمَنّي	(good) wishes, desires
تَمّوز	July
تَمويل	funding, financing
تَموين	supply, supplies, provisions, storing, hoarding staples for winter
تَمين،تمان	valuable, precious
تَمين،تَمينة	valuable
تَمييز	distinction, discernment, discrimination
تَنّ/تَنّو	short form of حَتّى إِنّو, until, for, in order to
تَنازُل	concession, rununciation
تَناسُل	procreation
تَناقُض	contradiction
تَناوُب	rotation, alternation
تَنبيه	warning
تَنزيل	bringing down, sending down, letting off, dropping off, reduction, decrease, one of the Qur'an's names
تَنسيق	coordination, arrangement
تَنضيف	cleaning
تَنظيم	organization
تَنَفُّس	breathing, respiration
تَنفيذ	implementation, execution, putting into practice
تَنقيط	vocalization, vowelization, pointing
تَنك	tank (container)
تَنَكة	tin, can
تَنَكُّر	disguise
تَنّورة،تَنانير	skirt
تَنويع	variety, diversity
تَنويم	hypnosis
تَنوين	the ن on the ends of indefinite nouns in MSA
تَنية	fold
تْنين،تاني	two
تنيْن/تَنيْن/تِنتيْن	two
تنيْنات	both of (us/you/them)
تنيْناتنا	both of us, the two of us
تنيْناتهم	the two of them, both of them
تَهبيلة	inhalation
تَهديد	threat
تَهَرُّب	escapt, avoidance, running away, evasion
تَهريب	smuggling
تُهمة،تُهُم	accusation, charge
تَهنِئة/تَهنِيّة،تَهاني	congratulations, good wishes
تَهويد	judaisation
تَهَيُّج	ferment, agitation
تَواظُن	equilibrium, balance
تَوافُق	compatibility
تَوأَم/توم،تَوائَم	twin
تَوان	slacking, slacking off, taking one's time
توب،تياب	dress, robe, cloak, garment (esp in plural)
توبة	repentance, mending one's ways
توت	mulberries
تَوَتُّر	tension
تَؤتيب	arranging, arrangement, order
تَوَّجوها	they crowned her
تَوجيه	direction, instruction
تَوجيهي	secondary (education)
توَحَّلَت	I got covered in mud
تَوحيد	unification, monotheism
تَوديع	farewell, goodbye
تور/ثَور،تيران	bull
تَوراه/تَورات	the Torah, the Pentateuch, the old testament
تَوَرُّم	swelling
تَوزيع	division, distribution
توستَر/تُستَر	toaster (see مَحمَصة also)
تَوَسُّط	mediation
تَوَسُّعِيّة	expansionism
تَوصِية	recommendation
تَوضيح	clarification
تَوظيف	investing, investment
تَوعِية	making aware, arousing awareness
تَوفير	economy, saving
تَوفيق	success
تَوَقُّع	expectation
تَوَقُّف	stop, halt, cessation
تَوقيت	timing, time
تَوقيع	signature, signing (more formal)
تَوقيف	stopping, arrest
تَوقيف،تَوقِيفَات	arrest, suspension
تَوليد	procreation, generating, generation, midwifery
توم	garlic
توم،توام	twins
تى	short form for حَتّى
تَيّار	current (water, electricity), draft (air), trend
تيْتا	grandmother, gran, granny, nan
تيْس،تيوس	billy goat, male goat, idiot, fool, stupid
تَيسَنة	stupidity, foolishness
تينة،تين،تينات	fig(s)
تيوب	inner tube (from english)
ثابَت	fixed, firm, steady, permanent, stable
ثالوث	trinity
ثانِيّاً	secondly
ثانِية،ثَواني	a second
ثائَر،ثُوّار	rebel, revolutionary
ثَدي،ثَديان	breast
ثَروة	fortune, wealth, riches
ثَقافة	culture, education, civilization
ثَقافي	cultural, educational
ثِقة	trust, confidence, faith, belief
ثَورة	revolution
ثَورَوي/ثَوَرجي	(a) revolutionary
جاج	chickens, fowl
جاجة	a chicken, tin, can
جار،جيران	neighbor
جار،جيران	neighbor
جارَح،جارحة	hurtful, wounding
جارَد	locusts (coll)
جارور،جَوارير	drawer (in Galilee, Lebanon, Syria)
جارور\جَرّار،جَوارير	drawer
جاروشة،جَواريش	millstones, handmill
جاري	current, active, valid
جاسوس،جَواسيس	spy
جاط	large bowl
جاعَد،جَواعَد	sheepskin
جافّ	dry
جاكَيت	jacket
جامَد	frozen, thick, hard, solid
جامَع،جَوامَع	mosque
جامِعة	university, league(?)
جامْعة،جامِعات	university
جامِعي	university (adj)
جانَب،جَوانَب	side, aspect
جاهة	deputation, delegation
جاهَز	ready
جاهَل،جُهّال	lacking knowledge, ignorant, reckless
جاي	coming, approaching, drawing near, next, fitting
جاي،جاي\جاية،جايين	coming
جايّة	arrival, coming (noun)
جائَز	possible, permissible, allowed
جائَز،جائزة	possible
جايزة/جائِزة،جَوائِز	prize, award
جَبّار	tyrannical, cruel, powerful, heroic, hero
جَبّالة	cement mixer, concrete mixer
جَبان	cowardly, coward
جَبّانة	cemetery
جِباية	levying
جُبّة،جُبَب	men's long outer garment, open in front, with wide sleeves
جَبري	enforced
جَبصين	plaster (cast)
جَبَل،جبال	mountain, hill
جَبَل،جْبال	mountain
جَبلة	portion of concrete
جُبُن	cowardice
جِبن،أَجبان	cheese
جِبنة	cheese
جَبهة	front, forehead
جبين	forehead
جُثّة/جِتّة/جِسّة،جُثَث/جُتَت/جُسَس	dead body, corpse
جَحش،جحاش/جحوش	donkey, young donkey, trestle (carpenter's tool)
جَخّة	style-consciousness, clothes-consciousness, showing off
جَخّيخ	clothes-conscious, style-conscious, showoffy
جَدّ	seriousness, earnestness
جِدّ،جدود	grandfather
جِدّاً	seriously, very
جداد	olive harvest (in some areas)
جِدار،جِدران	wall, fence
جِدال	argument, discussion
جِدّة،جدّات	grandmother
جَدَري/جِدري	smallpox
جَدوَل،جَداوَل	chart, table, list
جِدّي	serious
جَدي،جِديان	young goat
جِدِّيّة	seriousness, earnestness
جديد،جداد/جُدُد	new
جْديد،جْديدة،جْداد\جُدُد	new
جديلة،جدايَل	braid, plait
جَذر/جَزر،جُذور/جُزور	root
جَذري/جَزري	radical
جَرّ	pulling, traction
جُرءة	courage, boldness, daring
جَرّاح	surgeon
جِراحة	surgery
جَرادة	a locust
جَرّار،جَوارير	drawer (in Jerusalem), shutter, zip, zipper
جَرّار،جَوارير	shutter (of a shop)
جَرّافة	bulldozer
جَرائة	courage
جُربان،جَرابين	sock (in some areas)
جَرّة،جرار/جَرّات	jug, pitcher
جُرْثومة،جَراثيم	germ
جُرثومة/جُرسومة،جَراثيم/جَراسيم	microbe, germ
جُرح،جروح	wound, injury
جِرِح،جُروح	wound
جَرد	inventory, stocktaking
جَردون،جَرادين	rat
جَرزة/جَرسة/جَرسِيّة/جَرزاي،جَرازي/جَراسي	sweater, jumper (from English)
جَرَس،أجْراس	bell
جَرَس/جَرَص،أجراس/أَجراص	bell
جَرَسِيّات	bell tower
جُرعة،جُرَع	sip, gulp, mouthful (of liquid), dose (of medicine, an inoculation)
جُرن،جران/جرانة	mortar (basin in which things are ground)
جَرَنك	small sourish red or green plums (not much bigger than cherries)
جَرو،جراو/جِراء	puppy, cub
جَريح،جَرحى	wounded, injured
جَريدة،جَرايَد	newspaper
جَريدة،جَرايِد	newspaper
جَريمة،جَرايَم	crime
جَريئ،جَريئة	corageous, brave, resolute
جُزء،أَجزاء	part, volume of a book
جَزاء	punishment, penalty, fine, reward
جَزّاب	attractive
جَزائِري	Algerian
جَزِبِيّة	force of gravity, power of attraction, attractiveness
جُزْدان	purse
جُزدان،جَزادين	wallet, purse
جَزَر	carrots (coll)
جَزَرة	a carrot
جَزمة	a pair of boots
جَزيرة،جُزُر/جَزائَر	island
جُزئي	partial
جُزئياً	partially
جِسر،جسورة	bridge
جِسم،أَجسام	body, object
جِسمي	bodily
جُغرافيا	geography
جَفاصة	rudeness
جِفت،جفوتة	double barrelled hunting rifle, olive waste leftovers
جِفَش	rude, uncivil, abrupt
جِفن،جفون	eyelid
جَلّاية	dishwasher (machine)
جَلخ	sharpening, whetting, honing
جِلد،جلود	leather, skin
جِلدة	piece of leather
جِلْدة،جِلْد\جِلدات	leather
جِلدي	skin (adj)
جَلسة	meeting, a sitting (of a committee, council, etc)
جَلطة	blood clot, thrombosis
جَلي	washing up (dishes), polishing
جَليد	ice. تَلج more common
جَليسة	babysitter
جَليل	Galilee
جَماد	solid (noun)
جَماعة	group, band, gang (of friends)
جَماعَة،جَماعات	group, gang
جَماعي	collective, group-(adj), mass-(adj)
جَمال	beauty
جَمّال	camel driver
جَمب	side, beside
جُمجُمة،جُماجَم	skull
جَمر	embers, live coals
جَمرة	an ember, a live coal
جُمرُك	customs duty, custome house
جَمع	gathering, addition, plural
جُمعة،جُمَع	week, friday
جُمْعة،أُسْبوع	week
جَمعِيّة	association, club, organization
جَمَل،جمال،	camel
جُملة،جُمَل	sentence, totality, whole
جُملة،جُمَل	sentence
جُمهور،جَماهير	crowd, public
جُمهورِيّة	republic
جُمود	frozen state, deadlock
جَميع	all
جَميل	favor
جَميل	beautiful
جميلة	a favor
جِنّ	jinn (coll)
جَناح،جَنَاحات/جُنحان	wing (of bird, place, etc), wing, fender (of car)
جِنّاز،جَنانيز	funeral service, funeral rites, burial prayers (christian?)
جَنازة	funeral procession
جَنب	side
جَنْب،حَدّ	beside
جَنّة	paradise
جُندي	pawn (chess)
جُندي،جنود	soldier
جِنزار	verdigris (????)
جَنزبيل	ginger
جَنزير،جَنازير	chain (of medium to heavy thickness)
جِنس،أَجناس	species, type, kind, sex, gender
جِنسي	sexual
جِنسِيّاً	sexually
جِنسِيّة	nationality, sexuality
جُنفَيص	jute (???)
جنون	insanity, madness
جَنين،أَجِنّة	fetus
جْنينة،جَنَاْيِن	garden
جِهاد	(holy) effort
جِهاز،أَجهِزة	appliance, device, system, apparatus, equipment, gear
جِهة،جِهات	side, direction
جَهجَهون،عالجَهجَهون	aimlessly, haphazardly, at random
جُهد/جَهد،جهود	effort
جَهِد\جُهُد،جُهود	effort
جَهل	ignorance, foolishness, carelessness, recklessness
جَهَنَّم	hell
جَوّ،أَجواء	air, atmosphere, weather, climate
جَوّ،أجْوا	weather
جَواب،أَجوِبة	answer
جَواب،أجوِبة	answer
جَوّات	inside
جَواز	marriage
جَوافا	guavas (coll)
جَوّال	itinerant, travelling, wandering, portable, mobile, mobile phone
جِوّاني	inner
جِوّة	inside, indoors
جُوّة،جُوّات	inside
جودة	quality
جورة،جوار	hole (in the ground), pit, pothole
جوز	nuts (coll)
جوز،جواز	pair, husband
جوز،جْوَاز	husband
جوزة	one nut
جوع	hunger
جوعان	hungry
جَوف	cavity, depression (geo?)
جَوفي	inner, subterranean, underground
جَوق/جَوقة،أَجواق/جَوقات	choir, band, orchestra
جَولة	tour, excursion, round
جَوهَر	essence, principle
جَوهَرة،جَواهَر	jewel, precious stone
جَوهَري	essential
جِوّي	domestic, tame
جَوّي	air-(adj), atmospheric, meteorological
جي	suffix borrowed from Turkish to form professions or character traits
جَيب،جُيوب	nasal cavity / sinus
جَيب/جَيبة،جياب/جِياب	pocket
جَيَّد	good
جيرة	neighborliness
جيزة	marriage
جَيش،جيوش	army, soldiers
جيش،جْيوش	military, forces, army
جيل	generation, age
جين	gene
جَينة	coming, arrival
حابِب،حابّة،حابّين	loves
حاجّ،حُجّاج	pilgrim, old person
حاجَب،حَواجَب	eyebrow
حاجة	need, object, matter, stop! enough!
حاجَز،حَواجَز	roadblock, barrier, checkpoint
حاجِيّة	commodities, necessities
حاخام،حاخامِيّة،حاخامين	rabbi
حاد	sharp, vehement, acute
حادِث،حَوادِث	accident
حادَد/حادّة،حادّين	in mourning
حادَس/حادَث،حَوادَس/حَوادَث	event, incident, accident, mishap
حارّ	hot, warm, spicy
حارة	neighborhood, quarter
حارة،حَارَات	neighborhood
حازَم	resolute, determined, firm, drastic
حازوقة	hiccups
حاسّة،حَواسّ	sense
حاسِس،حاسّة،حاسّين	feeling
حاسَم/حاسمة	decisive
حاسوب،حَواسيب	computer
حاشِية،حَواشي	border, margin, marginal note, footnote, entourage, retinue
حاصَل	happening, outcome
حاضَر	present (now and here), ready, prepared
حاطِط،حاطّة،حاطّين	having put, having placed
حافَظ،حافظة،حافظين	guardian, keeper, one who has something (usually the Qur'an) memorized
حافي	barefoot
حاكورة،حَواكير	garden, yard, vegetable garden
حَاكُوْرَة،،حَوَاكِيْر	vegetable plot
حال	condition, self
حال،أَحوال	state, case, condition, instance, self
حالاً	immediately, at once
حالة	situation, condition, case
حالَق،حالقين	clean shaven, having shaved, having a haircut
حالِق،حالْقة،حالْقين	shaved
حالي	present (now)
حامَض/حامُض/حامضة،أَحماض/حَوامَض	sour, (in some areas) lemon, acid (noun or adj)
حامَل/حاملة،حاملين/حاملات/حَوامَل	carrying, pregnant
حامي	very hot, like iron or oil
حامي	protector, guard
حاوُوظ،حَواويظ	large water tank
حاوية	container
حايَك،حُيّاك	weaver
حَبّ	seed, grains
حُبّ	love
حَبّة،حبوب	grain, seed, berry, anything small and round, an individual item of fruit, veg, etc, pill, tablet, pimple, pustule
حَبّة،حُبوب	grain, pill, lozenge, tablet
حِبر	ink
حَبس	prison, jail
حَبَشي،حَبَش/أَحباش	Ethiopian
حَبل،أْحبال	rope
حَبْل،أحْبال	rope
حَبلة	rope, piece of rope
حَبَلة	terrace
حَبّوب	nice, pleasant, likable
حَبيب،حَبايَب	dear, beloved, sweetheart, boyfriend, girlfriend
حَتّى	until, as far as, up to, even, so that
حَجّ	pilgrimage (esp. the one to Mecca)
حِجاب،أَحجِبة،حُجُب	hijab, amulet
حجارة	pile of stones
حُجّة،حِجاج	pretext, grounds
حَجَر،أَحجار	stone, chesspiece
حَجَز	confiscation, siezure, impoundment, reservation
حَجَل	partridges (coll)
حَجَلة	partridge
حَجم،أَحجام	volume, size, capacity
حَدّ	anyone, someone
حَدّ،أْحدود	(alternative form of أَحَد) Sunday
حَد،حدود	limit, border
حَدا	anyone, someone
حداد	mourning
حَدّاد	blacksmith, locksmith
حدادة	ironmaking, smithery, smithing, the work of a blacksmith
حَداقة	wit, astuteness
حِدّة	sharpness, violence
حَدَث/حَدَس،أَحداث/أَحداس	young man, youth, event, occurrence
حِدَق	clever, sharp
حديث	conversation
حَديد	iron
حَديدة،حَدايَد	iron bar, piece of iron
حَديدة،حَديد	iron
حَديقة،حَدائَق	garden, park
حَرّ	heat
حُرّ	free
حُرّ،أَحرار	free
حُرّ،أحْرار	freedom
حَرارة	heat, warmth, fever, rash (on the skin)
حَراسة	guarding, guard
حَرام	forbidden, unlawful, illicit, taboo, shame, sacred (and inviolable), holy, sacrosanct
حَرامي،حَرامِيّة	thief, burglar
حَرامي،حَراميّة،حَراميين	thief
حَرب،حروب	war (f)
حَرب،حُرُوْب	war
حِرباية	chameleon
حَرت/حَرث	ploughing
حَرَج	distress, problem, difficult situation
حَردان	in a temper, sulky, sulking
حِردَبّة	camel hump
حَردون،حَرادين	agama (type of lizard)
حَرزان	worthwhile
حَرَس	guard, watch
حُرش،أَحراش	forest, wood
حَرف،أَحراف/حُروف	letter (of the alphabet)
حَرْف،حْرُوف\أحْرُف	letter of the alphabet
حِرفة	craft, trade, skill
حَرفي	literal
حَرفِيّاً	literally
حُرق،حروق	burn
حَرَكة	movement (political or physical), gesture, vowel
حَرَم	holy, sacred, sacrosanct, sanctum, holy place, wife (among Muslims)
حُرمة	sanctity, wife (among Muslims)
حُرِيّة	freedom
حَرير	silk
حَرّيف	expert, master
حَريق	fire, blaze
حَريقة،حَرايَق/حَرائَق	fire, blaze, conflagration
حَريقة،حَرَاْيِق	fire blaze
حَريم	women (the women of the family, among Muslims)
حَزّ،حزوز	segment, slice
حِزام،أَحزِمة	belt
حِزب الكَتائَب	the Phalangist Party (in Lebanon)
حِزب،أَحزاب	political party
حِزبي	(political) party (adj)
حِزِر،حْزُوْرَة	guess, assumption
حَزَر/حَذَر	caution, wariness
حُزم	sadness, unhappiness, grief, mourning
حِزمة،حُزام	bundle
حَزنان	sad, grieving, in mourning
حَزيران	June
حُزَّيرة،حَزازير	riddle
حُزّيرة،حَزارير	riddle
حَزين،حَزانا	sad
حِسّ	voice
حساب	arithmetic, calculation, bill, account, reckoning
حْساب،حْسابات	bill, account
حَسّاس	sensitive
حَسّاسِيّة	sensitivity, allergy
حَسَب	according to
حَسَد	envy
حَسرة	grief, sigh of grief
حَسَك	fishbones (coll)
حَسَكة	fishbone
حُسن	goodness
حَسَن،حِسان	good
حَسَنة	charity, advantage
حَسنة،أَبو حَسنة	Don Juan
حَسود،حُسّاد	envious
حسَيني	fox
حَشّاش	drug addict
حَشرة	crowding, crowd
حَشَرة	insect
حَشوة	stuffing, filling, tooth filling
حَشّور	nosy, prying
حَشيش	grasses, weeds, herbs, hashish, cannabis
حَشيشة	herb, blade of grass
حَصّاد	reaper, harvester (person)
حَصّادة	harvester, mowing machine
حِصار	siege, blockade
حصان	knight (chess)
حصان،حصونة/حُصُن	horse
حْصان،حْصُوْنِة\حُصُن	horse
حَصبة	measles
حُصّة،حُصَص	portion, share, lesson, class period
حَصر	blocking, retention
حَصرة	anguish
حَصوة	small stone, pebble, gravel
حَصيدة	harvest
حَصيرة	mat
حُضّ،أَحواض	basin, dock
حَضارة	civilization, culture
حَضاري	civilized
حَضانة	childcare, care of young children
حَضرة،حَضَرات	presence, sir/madan
حُضُن،أَحضان	breast, bosom, lip
حُضور	presence
حَطَب	firewood
حَطّة	keffiyeh
حَظّ	luck
حَفّاية	(pair of) slippers
حِفّة	side, edge, bank
حَفَرِيّات	excavations
حَفلة	ceremony, gathering, assembly, party, celebration
حَفْلة،حَفلات	party
حَفيد،أَحفاد	grandson
حَقّ	truth
حَقّ،حقوق	justice, truth, rightness, right (one's due), price, value
حَقل،حُقول	field (a grassy field), field (figurative), domain, sphere, realm
حُقنة،حُقَن	enema
حَقيقة،حَقايَق/حَقائَق	truth, fact
حَقيقي	true, real, authentic
حَكَم	referee (sport)
حُكم،أَحكام	judgement, verdict, sentence, rule, regime
حِكمة	wisdom, medicine
حُكومة	government
حُكومي	governmental
حَكوَجي	talkative
حَكي	speech, talk, way of speaking
حَكيم،حُكَماء	wise, wise person, doctor, physician
حَكيم،حَكيمة	sage
حَلّ،حُلول	solution
حَلّاق	barber
حَلّاق،حَلّاقة،حَلّاقين	hairdresser
حلاقة	haircut, shave
حَلال	permissible, possible, lawful
حَلالْ	mixed herd (of different animals)
حَلّان،حَلالين	terrace
حَلاوة	charm, refinement, sweetness, halva (a sweet made of sesame and honey)
حَلَب	Aleppo (city in Syria)
حَلبة	arena, track
حَلّة	(in some areas) the end of the work/school day
حِلّة،حِلَل	large pot, saucepan
حلرَس،حُرّاس	guard, sentry, watchman, custodian
حَلَزون	snails
حَلَزونة	a snail
حَلق	throat
حَلقْ	frame
حَلقة/حَلَقة،حَلَقات/حَلَق	circle, ring, earring, link, episode
حِلم،أَحلام	dream
حِلو	sweet, beautiful, nice
حِلو،حِلْوة،حِلْوين	beautiful
حَلَواني/حَلَوانجي/بَيّاع حَلوِيّات	confectioner, baker
حِلوِيّات	sweets, confectionary
حَلِيّاً	at present, at the moment
حَليب	milk
حلَيوى	handsome, good looking, good looker
حَمّ	heat
حَما/حَماي،حَمَوات	mother in law
حْمار	donkey
حمار،حَمير	donkey, ass
حَماس	enthusiasm, zeal, fervour
حَمّال	porter
حَمّالة	stretcher, luggage rack
حَمام	doves, pidgeons (coll.)
حَمامة	one dove/pidgeon
حِماية	defense, protection, protective window bars
حَمائَم	doves, pidgeons
حِمّة	fever
حَمد	praise
حُمرة	lipstick
حُمُّص	hummus, chickpeas
حَمضِيّات	citrus fruit
حَمل	carrying, pregnancy
حَمَل	ram, Aries (constellation)
حِمل	burden, load
حَملة	campaign, attack, offensive
حَمو	father in law
حُمودة	sourness, acidity
حمولة	cargo
حَمولة،حَمايَل/حَمائَل	extended family, relatives, clan
حَميد	praiseworthy
حَنان	love, affection (particularly maternal)
حَنبَلي	Hanabali
حِنّة	henna
حَنطور	horse-drawn carriage/cab
حَنَفي	Hanafi
حَنَفِيّة	tap, faucet
حَنَك	jaw
حَنون	conpassionate, tenderhearted
حَنّون	anemone
حَنين	longing, nostalgia
حَوادَس الْطُّرُق	road accidents
حِوار	discussion, conversation
حَوالا،حَوَلَي	round, about, around
حَوالَي	round, around
حوت،أَحوات،حيتان	fish, whale
حورة،حور	poplar
حورِيّة	attractive young woman, woman's first name, virgin in heaven
حوسة	fried onion
حوش،حواش	courtyard
حَوَل	squint
حَول	round, around, might, power, strength
حَول	around
حَيّ،أَحياء	living, alive
حَيّ،أَحياء	neighborhood, district, quarter
حَياء	shyness, modesty
حَياة	life, lifetime, late (dead)
حِياد	neutrality
حِيادي	neutral
حَياوي	vital, lively
حَياوِيّة	vitality
حَيّة،حَيايا	snake
حَيران	confused, disconcerted, embarrassed
حيرة	confusion, embarrassment
حَيط،حيطان	wall
حيط،حِيطَان	wall
حَيفا	Haifa
حَيفاوي،حَيافنة	person from Haifa
حَيل	strength, force
حيلة،حِيال	trick, ruse
حَيَّللّٰه	doesn't matter which ("may God sustain (them both)")
حين،أَحيان	time
حَيوان	animal
خاتَم،خَواتَم	ring (for the finger)
خارَج	outside, abroad
خارِجي	external, outside
خارطة،خارطات	map
خازوق،خَوازيق	disaster, calamity (originally a stake used to impale people)
خاصّ	special, particular, specific
خاصّ\خُصوصي	special
خاصّةً	especially, mainly
خاصرة،خَواصَر	hip, waist
خاطَب	engaged
خاطَر،خَواطَر	thought, mood, desire, inclination
خاطِرج خَوَاطِر	desire
خاطَئ/خاطِئة،خاطئين	sinner, mistaken, wrong
خال،خوال	maternal uncle
خَال،خْوَال	maternal uncle
خالة	maternal aunt
خَالة،خالات	maternal aunt
خالَص	completed, ready, finished
خالَق	creator
خالي	empty, free of, devoid of
خام	raw, unprocessed
خامَس	fifth
خامَل	sluggish, listless, apathetic, phlegmatic
خانة	square (on paper, on a chessboard), digit (number)
خانَق	suffocating, asphyxiating (adj)
خايَب	disappointed
خايَف	afraid
خايِف،خايِفة،خايِفين	fearful
خائَن،خَوَن/خَوَناء	traitor, deciever
خَبّاز،خَبّازة/خَبّازين	baker
خَبّازة	toaster
خَبَر،أَخبار	information, news, announcement, message
خَبَر،أخبار	news
خِبرة	experience, skill, expertise
خُبز	bread
خُبزة	a piece of bread
خُبْزة،خُبْز	bread
خَبصة	sticky mud, mire, mess, fiasco
خَبير،خُبَراء	expert, specialist
خَبير،خُبَرا	expert
خُبَّيزة	mallow
خَتيار،خَتيارِيّة	old man
خِتيار،خِتياريّة،خِتيارين	old (person)
خَجَل	embarrassment, shame, shyness
خَجلان	ashamed, embarrassed
خَجول	shy, bashful (by nature)
خَدّ،خدود	cheek
خَدّام	servant
خَدران	numb
خَدش،خدوش	scratch
خِدمة،خِدَمات	help, service
خِدْمة،خَدَمات	service
خَراب	destruction, debris, ruins
خَرابة	ruin / ruins
خَرّاسة	stapler
خَرّاط	turner (profession), braggart
خُرافة	legend, superstition, old wives' tale
خَرّامة	hole puncher
خَربان	broken, damaged, spoiled, out of order
خَربان،خَربانة،خَربانين	no good
خَرة	shit
خُرج	saddlebag
خَردَل	mustard
خَرَز	beads (coll)
خَرزة	a bead
خَرَس	muteness, dumbness
خَرطوم،خَراطيم	elephant's trunk, hose, capital of Sudan
خِرقة،خِرَق	cloth, duster
خُرم،خروم	hole, aperture (ONLY a hole going all the way through something)
خروج	stools (feces)
خروج	the act(ion) of going out
خَروف،خَرفان	sheep
خَرّيج	graduate
خَريطة،خَرايَط/خَرائَط	map
خَزّاقة	punch (hole), hole puncher
خَزّان	tank, boiler, reservoir
خَزانة حَديد،خَزايَن حَديد	safe (iron coffer)
خَزانة،خَزايَن	cupboard, closet, wardrobe
خَزانة،خَزَايِن	closet
خُزق،خزوق/خِزواق	hole (which goes all the way through)
خَسّ	lettuce (coll)
خسارة،خَسائَر	loss, damage
خَسّة	a lettuce
خَسران	loser, one who has incurred a loss
خَشّب،أَخشاب	wood
خَشَبة	a piece of wood
خَشْبة،خَشَب	wood
خُشّة،خُشَش	hut, shed
خُشم	nose
خِشَن،خشان	coarse, rough, harsh
خُشونة	roughness, coarseness
خِصَب	fertile
خَصر	waist, hips
خُصلة	tuft, lock (of hair)
خَصم،خُصوم	adversary, opponent, enemy, discount, reduction (in price)
خَصمِيّة	discount (in some areas)
خَصوة	testicles
خُصوص	matter, regard
خُصوصاً	especially, mainly
خُصوصي	special, personal, private
خَصيصة،خَصائَص	characteristic, property, feature
خُضراء	vegetables (fem. sing. coll. noun)
خُضراء/خُضَرجي	vegetables / greengrocer
خُضْرة،خُضار	vegetable
خُضْرة،خُضَر\خُضراوات	vegetable
خُضَرجي،خُضَرجِيّة	greengrocer
خُضَرْجي،خُضَرْجِيّة	greengrocer
خضَيرة،الخضَيرة	Hadera, a town near the Palestinian coast, halfway between حَيفا and تل ابيب)x
خَطّ،خطوط	line, track, handwriting
خَطَأ،أَخطَاء	mistake
خَطاء،أَخطاء	mistake, error
خِطاب	speech
خَطّاط	calligrapher
خُطّة،خُطَط	plan
خَطَر	danger
خَطَر،أَخطار	danger
خِطَر،خِطرة	dangerous
خَطرة،خَطرات	time (a single instance) (in some areas)
خَطم/خِطم،ختومة/خُتومات	(official) stamp, seal
خَطوة،خَطَوات	step
خُطورة	seriousness
خَطيب،خُطَباء	speaker, lecturer, preacher, fiance, suitor
خَطِيّة،خَطايا	sin
خَطير	serious, important, grave
خَفّاش،خَفافيش	bat (animal)
خَفّاقة،خَفّاقة بيض	eggbeater, whisk
خِفّة	lightness, agility
خَفَقان	palpitating, palpitations
خِفية	hiddenness, secrecy
خَفيف،خفاف	light, slight
خَفيف،خَفيفة،خْفاف	light weight
خَلّ	vinegar
خَلّاط	mixer, blender
خَلّاطة	cement mixer, concrete mixer
خَلاعة	moral depravity
خِلاف،خِلافات	disagreement, dispute, controversy, difference of opinion
خِلافة،خِلافات	succession, caliphate
خِلال	through, in, within, in the course of, during
خِلخال،خَلاخيل	anklet
خَلفي	back, rear (adj)
خَلفِيّة	background, context
خَلق	(the act of) creation, (the) creation
خَلقان	born
خَلَل	defect, fault, hitch
خلُند	mole (animal)
خلُوْ	emptying
خِلوة	solitude, place of retirement, Druze house of prayer
خُلود	eternity, immortality
خَلَوي	cellular, mobile phone
خَلِيّة،خَلايا	cell
خَليج،خُلجان	bay, gulf
خَليط	mixture, alloy
خَليفة	successor
خَليفة،خُلَفاء	caliph, successor
خَليقة،خَلائَق	creation, creature
خَليل	friend
خَليلي،خَلايلة	person from Hebron
خُمّ،خمام	chicken coop, henhouse
خَمر	wine
خَمس	five (for before a noun)
خُمس،أَخماس	(one) fifth
خَمسة	five (when the number stands alone
خَمسة،خَمْس،خامِس	five
خَمست	five (before a small number of specific nouns)
خَمستَعشر	fifteen (when the number stands alone)
خَمسين	fifty
خُمل	thicknes
خُمْل،خُمْلة	thickness (flat)
خَميرة	yeast, leaven
خميل	thick
خميل،خمال	thick
خْميل،خْميلة،خْمال	thick (flat)
خُنّاق،أَبو خُنّاق	diphtheria
خناقة	quarrel, fight, row
خَنجَر،خَناجَر	dagger
خَندَق،خَنادَق	ditch, trench
خَنزير،خَنازير	pig
خَنصَر	little finger, pinkie
خُنطة	hermaphrodite
خُنفُسة،خَنافَس	beetle
خُنْفُسِة\خُنِسْفِة،خَنَافِس	beetle
خَنوق	diphtheria
خوخ	plums, peaches (usage varies by region)
خُوْد،خوْدي،خوْدو	take
خورُس	(church) choir (from Greek)
خوري،خَوارنة	priest, parson, vicar
خوف	fear
خَوّيف	coward, cowardly, fearful
خيار	cucumbers (coll.)
خِيار	choice, option
خَيّاط	tailor, dressmaker, seamstress
خَيّاط،خَيّاطة،خَيّاطين	tailor
خِياطة	sewing, dressmaking, tailoring, needlework
خَيال	imagination, shadow, silhouette
خَيالي	imaginary
خَيبة،خَيبة أَمَل	disappointment
خَير	goodness, good, better
خَيش	jute
خَيط،خيطان/خيوط	thread, cord
خيط،خيطان	string
خَيمة	tent
خَيمة،خيام	tent
خَيى	brother, friend, mate, buddy
خَيّي،خَيّة	my brother, my friend
داخَل	inside, interior
دار،دور/دِيار	house, home
دارَج	ordinary, usual, common
داشَر،داشرة	abandoned
داعي	reason, necessity, need
دافَع،دَوافَع	motive
دافي	warm
دالية،دَوالي	vine
دامي،دامِيّة	bloody
دان،دِنَين	ear
دان،دِنْتين،دْنين	ear
داهية،دَواهي	disaster, calamity
داية	midwife (more common)
دايَر	round (prep), around
دايَر،دايرة،دايرين	revolving, roaming, travelling around, looking for, thinking about, preoccupied with
دايِر،دايِرة،دايِرين	being careful (act)
دائِرة/دايرة،دَوائَر	circle, office, department
دائَم/دايَم	lasting, constant, perpetual
دايْمّا	always
دايمة	an expression of gratitude addressed to one's host after drinking coffee of concluding a meal
دَبّ،دباب/دَبَبة	bear
دَبّابة	tank (military), bracelet composed of flattened links
دُبّار	solution, way out
دَبّاغ	tanner (leather)
دباغة	tanning (leather)
دُبّان	flies
دُبّانة	a fly
دَبَسة	thick stick
دَبش	large rock, stones or rocks the size of a fist or larger
دَبلان	wilted, withered
دِبلة	engagement ring, wedding ring
دَبّور	large wasp, hornet
دَبّوس،دَبابيس	pin, clip, brooch
دَح	very nice! isn't that nice!
دُخّان	smoke, tobacco
دَخل	income (money), connection (to a topic)
دَخلة	entering, consumation of marriage
دُخول	entrance, entry (the act of entering)
دَخيرة،دَخائَر	ammunition, munitions
دَخيل	protégé, one who seeks asylum
دَخيلي	inner, interior
دراس	threshing
دَرّاسة	threshing machine
دِراسة	study, studying, studies
دَرَبزين	railing
دُربَكّة،دَرابيك،دُربَكّات	darabukka (a kind of clay drum)
دُرة،ذُرة	maize, sweetcorn
دَرَج	stairs
دَرَجة،دَرَج،دَرَجات	step, stair, degree, rank
دَرَجة،دَرَج\دَرجات	stairstep
دَرَجة،دَرَجات	degree
دَردَشة	chatting, a chat
دَرزة	seam, hem
دُرزي،دُرزِيّة،دروز	Druze
دَرس،دروس	lesson, study
دَرْس،دْروس	lesson
دُرَّق	peaches
دَرَقي	thyroid
دَزّينة	dozen
دِست،دسوتة	very large saucepan, large pot, cauldron
دَستة	pile, pack, wad
دَستور	constitution (govt), permission, leave
دُش	shower (from french)
دَعارة	pornography, indecency, debauchery
دِعاية	propaganda, publicity, advertizement, promotion
دِعائي	propaganda (adj), publicity (adj), propagandist
دَعدورة	bump, bruise
دَعسة	footprint, track, pedal
دَعَم	support
دَعوة	invitation, blessing, curse
دَعوة،دَعاوي	lawsuit, claim, legal case, hearing, problem
دُغري	straight, direct, honest, straight ahead, truth
دُغْري،دُغْريّة،دُغرِيِّيْن	straightaway
دَفّاش	propeller
دِفاع	defence
دَفّاي	heater, stove
دَفّة	board, small plank, leaf (of a double door), rudder
دَفتَر،دَفاتَر	exercise book, notebook
دَفتَر،دَفاتِر	notebook
دِفتيرية	diptheria
دَفع	payment, paying
دَفعة	instalment (in a series of payments), time, occurrence
دَفْعة،دَفعات	payment
دَفن	burial
دَفيان	warm
دَقّة	a knock, a ring
دِقّة	accuracy, precision, meticulousness
دَقَّة،دَقَّات	ring, knock
دُقماق	mallet, wooden hammer
دَقْن	chin, beard
دَقن،دقون	beard, chin
دَقيق	delicate, precise, accurate, meticulous, fine
دقيقَة،دَقايِق	minute
دُكّان،دَكاكين	shop, store
دُكّان،دَكاكين	shop
دُكّانجي	shopkeeper
دُكْتُر،دُكْتورة،دَكاتْرة	doctor
دُلاب	wheel
دَلَع	pampering
دَلو	bucket, Aquarius
دَلّوع	spoilt
دَليل،أَدِلّة	guide, guidebook, instruction manual, sign, indication
دَليل،أَدِلّة	proof
دَمّ	blood
دماغ،أدمِغاء	brain
دِمّة،ذِمّة	conscience
دِمّة/ذِمّة	conscience
دَمج	absorption, incorporation, integration, assimilation
دِمَشق	Damascus
دَمعة،دموع	tear
دُمَّل	boil, abcess
دُمية،دُمة	doll, dummy, puppet
دُن،دِنين	ear
دِناري	diamonds (suit in cards)
دَنَب،دناب،أَدناب	tail, follower, supporter, henchman, hanger-on
دُنُم،	dunam (1000 square meters)
دِنيا	world
دهان	paint (oil or plastic)
دَهّان	painter
دَهَب	gold
دَهن	painting, coating, spreading
دُهُن،دُهون	oil, fat, grease
دُهنة	a piece of fat
دُهني	fatty, greasy
دهون	ointment
دَهّين	painter
دَوا،أدْوِية	medicine
دَواجَن	poultry
دُوّار	roundabout, traffic circle
دَوام	workday, working hours
دَوّام	whirlpool, cycle
دوب،يا دوب	scarcely, hardly, only just
دَوة،أدوِية	medicine, medication
دوخة	dizziness, vertigo
دود	worm
دودة	one worm
دور،أدوار	queue, line, role, part, time, turn, instance
دَوَران	turning, circling, revolution
دورة	turn, revolution, round trip, tour, procession, cycle, course
دورة،دورات	course
دَوري	circular, periodic, cyclical
دَورِيّة	patrol
دَوشة	noise, racet, commotion
دولاب،دَوَالِيْب	wheel
دَولة،دُوَل	state
دوَيري	sparrow
دِيانة	religion, religious denomination
ديب،دياب/دِئَب	wolf
دِيّة	blood money, ransom
دَير	monastery, convent
دير،ديري،ديرو	careful!
ديق	stress, trouble
دَيَّق	narrow
ديك،ديوك	cock, rooster
ديكور	stage scenery
دَين،ديون	debt, credit
دينار،دَنانير	dinar
ديوان،دَواوين	large sitting room for recieving guests, anthology of poems, tall story
ذَرّة/زَرّة	atom
ذَرّي/زَرّي	atomic
ذِهَن	mind, intellect
ذِهني	mental, intellectual
ذوق	taste in
رابطة،رَوابَط	tie, connection, union, association
رابَع،رابعة	fourth
راتَب،رَواتَب	salary
راجِع،راجْعة،راجْعين	returning (act)
راحة	rest, turkish delight
راحَل،رُحّال	nomadic, late, deceased
رادَع،رادعة	deterrent
راديو	radio
راس	head
راس،روس	head
راس،روس	head
رأَساً	directly, immediately, straight, straight away
راسي	anchored
راشَد	adult, grown-up, not a minor
راصَد،رُصّاد	watcher, observer
راضي	satisfied, pleased
راضي،راضْية،راضين	satisfied
راعي،رُعيان	shepherd
رافعة	crane
راقة	coat (of paint etc)
راقي	superior, top-quality, high grade, high class, advanced, refined
راكِب راكْبة،رُكّاب	rider
راكَب،رُكّاب	riding, rider, travelling, passenger
راكَد	calm
راكَز	stable (mentally or physically), settled
راكَع	kneeling
رامي،رامْية،رامْيين	thrower
راهَب،رُهبان	monk
راهبة	nun
رأَي،أَراء	opinion
رَأي،أراء	opinion
رايَب	off, sour, curdled (of milk)
رايَج	in demand, selling like hotcakes
رايَج/رائَج	in demand, selling well
رايِح،رايِحة،رايِحين	going (act)
رائَد،رُوّاد	leader, explorer, major (mil)
رائَع،رائعة	wonderful, splendid, magnificent
رُبّ	purée, puree
رَبّ،أَرباب	master, lord, owner, proprietor, Lord, God
رَباح	gain
رَبّاط	shoelace(s)
رِباط	bond
رِباعي	quadrilateral, having four root letters
رَبّة	mistress, (female) owner, proprietress
رِبَح،أَرباح	gain, profit
رَبحان	gainer, winner
رَبطة،رَبطات	knot, tie, necktie, armband, bandage
رُبُع/رُبَع،رباع	quarter
رُبَّعِيّة	check, square
رُبَّما	perhaps, it's possible that
رَبوح،رَوابيح	large plane (carpentry)
رَبيع	Spring
رُتبة،رُتَب	rank
رَتَل	column, convoy
رَجاء	hope, request
رُجّال،رجال	man (again)
رَجَب	seventh month in the Muslim year
رَجعة	return (noun)
رِجَل،رِجليْن،أَرجُل	foot, leg
رَجُل/رُجّال،رجال/رِجال	man
رُجوع	return, coming back
رُجولة	masculinity, manliness, manhood
رِجيم	diet (from French)
رِحلة،رِحَل	excursion, trip, tour
رَحَم	womb, uterus
رَحمان	merciful
رَحمة	mercy
رَحيم	compassionate
رَخاوة	softness, flabbiness
رِخصة،رُخَص	license, permit (noun)
رُخْصَة،رُخَص	license
رَخو	(too) soft, slack, loose, flabby
رْخيص،رْخيصة،رْخاص	cheap
رَدّ،رُدود	return, reply
رَدٍئ،رَدٍئة،أَردِياء	bad, evil, wicked, bad, poor (as in not good)
رَدييْتَر	radiator
رُزّ	rice
رَزالة/رَذالة	baseness, despicable behaviour, depravity, a disgusting way to behave
رِزَق	livelihood, a living, daily bread
رُزنامة	calendar
رَزيل/رَذيل،أَرزال/رُزَلاء/رُزّال	despicable, contemptible, nasty, depraved
رِسالة،رِسائَل	letter, message, mission, vocation, assignment
رِسالة،رَسايل	letter, message
رَسّام	painter, artist
رَسَم	drawing
رَسَم،رُسوم	fee, due
رَسمال	capital, purchase price(?)
رَسمالي	capital- (adj), capitalist
رَسمة،رُسومات	drawing, sketch
رَسمي	formal, official
رَسَن،رسان	halter (something you put on horses??)
رُسوب	sediment, dregs, precipitation, failure
رَسول،رُسُل	messenger, envoy, emissary, apostle (usually religious)
رَشّاش	machine gun, submachine gun, sprinkler (irrigation)
رَشّاق	whitewasher
رَشّة	pile
رَشّة	a spray
رُشَتّة/رُشيْتة/رُشّيْتة	prescription
رَشَح	cold, chill, the cold
رَشِح،رْشُوحات	cold, sniffles
رَشَّحوه	they nominated him
رُشد	maturity, majority, full legal age
رَشَق	whitewashing
رَشوة،رَشاوي	bribe
رصاص	lead, bullets
رصاصة	bullet (piece of lead)
رَصيد	balance (bank), funds
رَصيف،أرْصِفة	pavement, sidewalk, platform
رَصيف،أَرصِفة	pavement, sidewalk, platform, quay
رِضاء	satisfaction, contentment, approval, agreement, consent
رَضّة	bruise
رُطَب،رُطبة	damp (adj)
رَطُل/رُطُل،أَرطال/أَرطُل	a unit of weight equivalent to 3 kilos (Jerusalem)
رطوبة	damp, dampness
رَعبون	deposit, pledge, earnest money
رَعد	thunder
رعِيّة	itch
رَغبة	wish, desire
رَغَم،بِاْلْرَّغَم مِن	despite, in spite of
رَغوة	foam, froth, lather
رغيف،أَرغِفة/أَرِغفة	loaf
رَفّ،رفوف	shelf
رَفّاص	spring (in mattress etc)
رَفاهِيّة	luxury, comfort, ease
رَفض	refusal, rejection
رَفيع،رفاع	thin, slender, slim, narrow (usually round but not flat), high pitched
رْفيع،رْفيعة،رْفاع	thin (round & long), slender, slim, skinny
رفيق،رُفَقاء/رِفقات	friend, companion
رَقابة	supervision, control, censorship
رَقَبة	neck
رَقص/رَقصة،رَقصات	dance, dancing
رُقطِيّة،رُقطِي/رُقاطي	turtle dove
رُقعة،رُقَع	patch, a type of Arabic script (often handwriting)
رَقَم،أَرقام	number, digit
رَقيب،رُقَباء	sergeant
رَقيق	delicate
رقيق،رقاق	thin, fine (of flat object)
رَْقيق،رَْقيقة،رْقاق	thin (flat), delicate, fine, sensitive, gentle
رَكّ	burden, onus, responsibility
ركاض	running
رُكبة،رُكَب/ركاب	knee
رَكَت	raquet
رَكض	running
رَكعة	prostration, kneeling
رُكُن،أَركان	pillar, prop, base
ركوب	riding
رَماد	ash, ashes
رَمادي	grey
رُمّانة،رُمّان	pomegranate(s)
رُمبيل	a ball bearing (from french)
رَمز،رُموز	symbol, sign, emblem, character (script)
رَمزي	symbolic, token-
رَمش،رموش	eyelash
رَمشة	blinking, blink
رَمَضان	the ninth month of the Muslim year
رَمَل	sand
رَمي	throwing, shooting
رَمياً	by shooting, by throwing
رَنّان	resonant
رَنّة	echo, ringing, repercussions
رُنجُس	Narcissus
رُندَلّا	washer (from french)
رَهبانة	monastic/religious order
رَهَن	pledge
رَهنِيّة	mortgage, pledge
رَهينة،رَهائَن	hostage
رَواج	saleability, demand, call, sales
رَواق	peace, quiet, tranquility
رِواية	novel, story, play, version
رِواية،رِوايات	novel, story
روح،أَرواح	spirit, soul
روحاني	spiritual, alcoholic
روحة	departure
رَوَّحَت	she had an abortion (in some areas)
روداج	running-in (of car) (from french)
روسي،روس	Russian
روسيا	Russia
رَوضة،رِياض	garden
روماني،رومان	Roman
رومي،روم	Greek Orthodox
رُؤية	visibility
رَيّ	irrigation
رِئاسة	presidency
رِياضي	sport-related, athlete, sportsman, mathematical, mathematician
رِياضِيّات	math, mathematics
رِيالة	drool, slobber
رِيّة	lung (again)
رِئة،رِئات	lung
ريح،رياح/أَرياح	wind
ريحا،أَريحا	Jericho
ريحان	sweet basil, basil
ريحاوي،رِحاوِيّة	of Jericho
ريحة،رَوايَح	smell, scent
رَيَّس،رَيّسة	head, superior (of monastery etc)
ريش	feathers
ريشة،رِياش	feather, nib (of pen), drill bit, blade of a (carpenter's) plane
ريق	saliva
ريْقان	hepatitis, jaundice
رَئيسي	main, principal
زات	self
زاف	edge (of fabric)
زاكي،أَزكاء	tasty
زاني	adulterer
زانية،زَواني/زانِيات	adultress
زاوية،زَوايا	angle, corner, column (newspaper), selection (newspaper), supplement (newspaper)
زائَد	increasing, more, plus
زايدة	appendix
زائَر،زُوّار	guest. visitor
زائِر،زائِرة،زُوّار	visitor
زَبّال	garbage collector
زبالة	garbage, rubbish, trash, refuse
زِبدة	butter
زَبور	the Book of Psalms
زبون،زَبايَن	client, customer
زبيب	raisins (coll)
زَتونة/حَبَّةْ زيْنون	an olive
زُجاج	glass (formal)
زُجاجي،زُجاجِيّة	glazier, glass- (adj)
زَحلِفة	some kind of lizard
زَحلوقة،زَحاليق	slippery area (usually plural)
زَحمان	busting, really needing to use a bathroom
زَحمة	overcrowding, crush, pressure, crowd
زَحْمة،زَحْمات	crowd, overcrowding, crush
زَخّة	[sudden and heavy] shower/rain
زَخرَفة،زَخارَف	decoration, ornamentation
زِدلاوي	left handed
زِرّ،زْرَار	button
زَرّ/زِرّ،زرار	button, knob, a single item of certain types of vegetable
زَرادة	link, disc (spine)
زِراعة	agriculture
زِراعي	agricultural
زَرافة	giraffe
زَرَدِيّة	pliers
زَرَع	sowing, planting, transplant
زَرَع،بيِزرَع	(plants) to sow, plant, to transplant (organs)
زَرفيل،زَرافيل	lock (in Jerusalem)
زَرَق جُوّا	he snuck inside
زَرَق لَبَرّا	he snuck outside
زريبة،زَرايَب	pen, corral
زَرّيعة	plant(s), flower(s), decorative plant(s)
زَريف	elegant, nice, charming, witty, amusing
زَعبوبة،زَعابيب	spout, lip
زَعتَر	thyme, a mi of thyme, salt, and toasted sesame
زَعفَران	saffron
زَعَل	anger, irritation, annoyance, distress, fuss
زَعلان	upset, angry, annoyed, distressed, sorry?
زَعْلان،زَعْلانة،زَعْلانين	angry
زَعنَفة،زَعانَف	fin
زَعيم،زُعَماء	leader
زَغاريت	high pitched trilling sound
زُغبُر	down (soft feathers)
زَفّة	wedding procession, shouts, shouting
زِفت/زِفَت،زِفتة	tar, asphault, tarmac, awful, dreadful, the pits, road
زَفير	inhalation
زَقزَقة	bird sounds
زَقطة	tag (children's game)
زَقفة	clapping, applause
زُقّيْطة	tag (child's game)
زَكا	cleverness, intelligence, insight, understanding
زَكاة	alms tax
زَكَر،زُكور	male
زَكرة	memory (ability to remember)
زِكرى	memory
زِكرَيات	memories, memoirs
زَكي،أَزكِياء	smart, intelligent, clever, bright
زَلابية	small balls of dough fried and dipped in syrup
زَلّاقة،زَلاقات لِلْتَّلج	skis
زَلال/زُلال	protein, egg white, albumen, albumin
زِلزال،زَلازَل	earthquake
زَلَمة،زُلام	man, guy, bloke, dude, grown man
زَلَمة،زْلام	man
زَمان	time, period, era, long ago, the old days, once
زَمان،زَمانَات	period (time)
زَمب،زُموب	sin, guilt
زُمبَرَك	spring (gun), mainspring (watch), suspension (vehicle)
زَمبوعة/زَنبوة،زَمابيع/زَنابيع	spout, lip (again?)
زَمّور	sired, alarm, (car) horn
زَميل،زُمَلاء	colleague, co-worker, companion, fellow student, etc
زميل،أَزاميل	chisel
زِناء	prostitution
زناد	trigger
زُنّار،زَنانير	belt, girdle (of fabric)
زِند	wrist
زِندي،زنوج	black person (racist word?)
زِنزانة،زَنازين	prison cell (of solitary confinement), paddy wagon
زَنطَرِيّة	dysentry
زَهَر	flowers (coll), cauliflower(s) (coll), dice
زَهْر،زَهْرَة،زْهور	flower
زَهرة	cauliflower
زَهرة،زهور/أَزهار	flower
زَهري	pink
زَهري،زُهَري	syphilis
زَهقان	bored, sick and tired, fed up
زَواج	marriage
زُوّادة	provisions (for a trip, for the school/workday)
زوبَعة،زَوابَع	storm
زوبَعة،زَوابِع	storm
زوَرَت،أَعطيني أَشرَب	my food's gone down the wrong way, give me something to drink
زوق،أَزواق	taste, tact
زَيّ	like, as
زَيّ ما	however
زِيّ،أَزياء	clothes, fashions (mainly plural)
زيادة	increase, surplus, extra, spare, excess, too much
زْيادة،زْيادات	increase, extra, excess, too much
زيارة	visit
زيْبَق	mercury, quicksilver
زيْت،زيوت	oil
زيت،زْيوت\زيتات	oil
زيْتون/زَتون	olives
زيتون\زَتون،زَتونات	olive
زير	large jar (once for storing water, now for decoration)
زينة	beauty, decoration, ornament
سابَع	seventh
سابَق	previous, former, ahead of, in advance of
سابِق،سابْقة،سابْقين	previous
سابِقة،سَوابَق	(criminal) record (mainly used in plural)
ساتَر	protector, guardian
ساحة	courtyard, square, plaza, open space
ساحَر/ساحِرة،سَحَراء/ساحرين/ساحرات	magician, shaman, sorcerer, conjurer, wizard
ساحَل،سَواحَل	coast, seashore, littoral
سادا	plain, unadorned, without milk/sugar (coffee), self-colored (
سادَس،سادسة	sixth
سادِيّة	sadism
سارَح	distracted, absent minded, wool-gathering, spaced out, (roaming, leading flocks to pasture)
سارِح،سارْحة،سارْحين	distracted
سارَق	stealer, thief
ساري	applying, applicable, in force, contagious
ساعات،أَوقات الإستِقبال	opening hours
ساعة	hour, watch, clock, counter, meter, speedometer
ساعَة،ساعَات	watch, clock, hour
ساعَتها	then, just then, at that moment
ساق،سِقان/سوق	leg, calf (of the leg), stalk, (tree) trunk
ساقَط	fallen (literal or figurative), disreputable
ساقطة	fallen woman
ساقية،سَواقي	irrigation canal
ساكِت،ساكْتة،ساكْتين	silent
ساكَت/ساكتة،ساكتين	silent, quiet
ساكِن،ساكْنة،ساكْنين	lives
ساكِن/ساكنة،ساكنين	living/residing, resident
سالَم/سالمة،سالمين	well, safe, all sound
سامِري،سَمَراء/سامرا	Samaritan
سامِع،سامْعة،سامْعين	hearing (act)
سامي	high, exalted, lofty, sublime
سامي	Semite, Semetic
ساهي	absent-minded, inattentive
سايَب،سايبة	abandoned, neglected, wandering
سائَح/سايَح،سُوّاح/سُيّاح	tourist
سايَغ،سُيّاغ	goldsmith, silversmith
سائَق،سائَقين/سُوّاق	driver
سايق،سايْقة،سايْقين	driver
سائَل،سَوائَل	liquid, fluid
سُبّابة	valve
سباتي	club (playing cards)
سباحة	swimming
سباعي	premature baby (seventh month born)
سباق	race, competition
سَبّاق	pioneer, ground-breaker, front runner, record-holder
سَبانَخ	spinach
سَبَب،أَسباب	reason, cause
سَبَب،أسْباب	cause, reason
سَبت/سَبَت،سبوت	Saturday, the sabbath
سِبط،أَسباط/سباط	tribe (in biblical times)
سَبَع	seven (before a noun)
سُبُع،أَسباع	a seventh
سَبعة	seven 7 ٧
سَبْعة،سَبْع،سابِع	seven
سَبَعتعَش	seventeen (when number is alone)
سَبَعتَعشَر	seventeen (before a noun)
سَبعين	seventy 70 ٧٠
سَبغة	dye
سَبَق	already, before
سَبَق : يسْبُق	overtake, precede
سَبَقتَك	I arrived before you
سَبَلة،سَبَل،سَبَلات	ear(s) (of wheat/corn/etc), bar (rank insignia)
سَبَلتيْن/تلات سَبَلات	two/three ears (of corn etc)
سبَنيولي،سبَنيول	Spanish
سبيْر	spare wheel
سبيكة،سبايَك	ingot
سَبيل	sake, means, way
سِتّ	six (used before a noun)
سِتّ	lady, woman, grandmother
سِتّ،سِتّات	grandmother
ستار	curtain, screen
سِتّة	six
سِتّة،سِتّ،سادِس	six
سِتَّعَش	sixteen (when number is alone)
سِتَّعشَر	sixteen (before a noun)
سْتَنَّى،سْتَنّي،سْتَنّو	wait
ستيرِنغ	steering wheel
سِتّين	sixty
سِجّاد،سَجاجيد	carpet, rug, prayer rug
سِجارة،سَجايِر	cigarette
سَجّان	warder, prison guard
سَجَر	trees (an unusual pronounciation found in Galilee and elsewhere)
سِجِل	record, register, file, archive
سَجين،سُجَناء	prisoner
سَحّاب	zip, zipper, zip fastener, bangles (in some areas)
سَحّارة،سَحاحير	box, crate
سَحّارة،سَحاحير	crate
سِحاقِيّة	lesbian
سَحَب	pulling, drawing, taking, draw (lottery), turnover, takings, withdrawal
سَحبة	at/in one go, all at once, at one fell swoop, lottery ticket
سَحجة	clapping
سِحَر	magic spell, charm, enchantment
سِحري	magic, magical
سِحسَلِيّة	slide (playground)
سُحسيْلة،سَحاسيل	slide (playground)
سَحلَب	wild orchid, orchid, salep (a cream thickener thing made from orchid tubers), sahleb (a drink made from tubers, milk, and sugar)
سَحلِيّة،سَحالي	lizard
سحور	final pre-dawn Ramadan meal
سَخاوة	generosity
سُخرِيّة	sarcasm, irony, scorn, derision
سُخُن/سُخنة	warm, hot
سَخَن/سَخنة،سَخنين/سَخنات	feverish, having a fever
سخونة	fever
سَخي،أَسخِياء	generous
سَخيف	stupid, silly
سَدّ	closing, blocking, settlement (debt), dike, dam
سدادة	plug, cork, stopper
سَدّان،سَدادين	anvil
سِدّة،سَدَد	loft, attic
سِدر،سدورة	chest, breast. large serving tray, front room, reception room
سُدس،أَسداس	a sixth
سَرّ الْصَّنعة/المِهنة	trade secret, professional secret
سِرّ،أَسرار	secret (n)
سَراب	mirage
سَرّاق	thief
سِرب،أَسراب	herd, flock, swarm, flight
سِرداب،سَراديب	tunnel, underground passage
سِرساب	obsession, phobia
سَرسَري	crook, con artist
سَرَطان	cancer
سُرعة	speed
سَرفيس	service taxi (a communal taxi thing)
سِرقة	theft
سُرور	joy, happiness, gladness
سِرّي	secret (adj)
سِرياني،سِريان	Syraic
سِرِّيّة	secrecy, discretion
سرير،أَسِرّة/سَرايَر	bed, cradle, crib
سَرير،تَخْت	bed
سَريع	fast, swift, quick, speedy
سِشوار	hairdryer, blowdryer
سَطَح،سطوح	surface, [flat] roof
سَطحي	surface- (adj), superficial
سَطَر،أَسطُر/سطور	line (of text, or in a ruled notebook)
سَطَل،سطول/سطولة	bucket, stupid person
سطيْحة	balcony
سَعادة	happiness
سَعد/أَبو سَعد	stork, storks
سَعدان،سَعادين	monkeys
سِعَر،أَسعار	price
سَعلة	cough
سُعلة/سَعلة	cough (noun)
سَعيد	happy
سَعيد،سَعيدة،سَعِيدِين	happy
سَفارة	embassy
سَفَر	travel, travelling
سِفَر،أَسفار	book (of the bible
سِفَر/صِفر،أَسفار/سفورة/أًصفار/صفورة	zero
سَفرة	journey, trip
سُفرة	dining table
سَفْرة	a specific journey
سَفَرِيّة	journey, trip, tour
سَفك	bloosdhed
سِفلية	syphilis
سفِنج	sponge (the substance)
سفِنجة	a sponge
سفيحة	flat pieces of meat baked on a layer of flaky pastry and garnished with onions
سَفير،سُفَراء	ambassador
سفين،أَسافين	wedge
سَفينة،سُفُن	ship
سقالة	scaffolding
سَقعة	intense cold
سَقف	ceiling, roof
سُقوط	fall, drop
سَقي	irrigation
سكافي	shoemaker, cobbler (obsolete?)
سُكّان	resident
سِكّة	way, path, road, ploughshare, plough
سَكَت	silence, quiet
سَكتة	silence, quiet
سُكَّر	sugar
سُكُر	drunkenness
سَكران	drunk, intoxicated
سَكْران،سَكرانة،سَكْرانين	drunk
سَكرة	drunkenness
سُكَّرة،سُكاكير	lock
سِكَرتيْر	secretary (m)
سِكَرتيْرة	secretary (f)
سُكَّري،مَرَض الْسُّكَّري	diabetes
سكَملة	small coffee table
سَكَن	residing, residence
سَكَني	grey (????)
سُكوت	silence
سَكوت	quiet, taciturn
سَكّير	drunkard, drinker
سِكّينة،سَكاكين	knife
سِكّينة،سَكَاكِين	knife
سِلّ،مَرَض الْسِّلّ	tuberculosis
سِلاح،أَسلِحة	weapon, arm, (in armed forces) force, corps, service
سَلام	peace, peacefulness
سَلامة	safety, well-being, welfare
سَلامْتَِك	Take care!
سَلبي	negative, passive
سَلّة،سلال	basket
سَلّة،سْلال	basket
سُلَحفاه،سَلاحَف	turtle, tortoise
سِلسِلة،سَلاسَل	chain, series
سُلطان،سَلاطين	sultan, ruler, sovereign
سَلَطة	salad
سُلطة	power, authority
سَلطَعون،سَلَطعين	crab
سَلَف	payment in advance
سِلف	starter (car engine)
سَلَفاً	in advance
سُلفة	deposit, down payment, advance
سِلفة،سِلَفات	sister in law (wife of your husband's brother)
سِلك،أَسلاك	wire, staff, corps
سِلكي	wire- (adj)
سِلَّم،سَلالَم	ladder, scale (music)
سِلمي	peaceful
سِلِندَر	cylinder (car engine)
سلوك	behaviour
سَليم	healthy
سَمّ،سموم	poison, venom, drug
سَما،سَماوات	sky, heaven
سَماح	forgiveness
سَماد،أَسمِدة	fertilizer, manure
سَمار	goats (brown)
سَمّاعة	telephone reciever, earphones, loudspeaker, stethoscope
سَمّاك	fishmonger
سَمّان	grocer
سُمّانة،سُمّان	quail
سَماوي	celestial, heavenly, divine
سِمَج،سِمجة،سِمجين	rude, nasty
سِمسار،سَماسرة	dealer, broker, estage agent, agent, middleman
سَمسَرة	brokerage, commission, fee
سِمسَم	sesame
سَمَع	hearing
سُمعة	reputation, good name
سُمك	thickness
سَمنة	clarified butter, ghee
سميد	semolina
سميك	thick (rare)
سمين،سمان	fat, plump (usually animals)
سِنّ	age
سِنّ،سنان/أَسنان	tooth
سِنّ،سْنان	tooth
سنَبَرز	shock absorber
سُنّة	Sunna (the portion of Islamic law based on Mohammed's words and actions), law (of nature etc)
سِنة،سْنين	year
سَنة/سِنة،سَناوات/سنين	year
سَنترال	telephone exchange
سَنتيْن	two years
سِنجاب	squirrel
سَنَد	prop, support, strut, security, bond
سَندوق،سَناديق	box, chesh, boot / trunk (car), cash register
سَندويش/سَندويج	sandwich
سِنديان	evergreen oak, holm oak, holly oak
سِنسال،سَناسيل	(thin) chain
سِنَسلة،سَناسَل	drystone wall used to partition fields and gardens
سَنطي/صَنطي	centimeter (plural and singular)
سنونو	a swallow, swallows (bird)
سَنَوي	annual, yearly
سُنّي	Sunni
سَهران	awake, up (not in bed)
سَهْران،سَهْرانة،سَهْرانين	one staying up late
سَهرة	evening out, evening spent in company
سَهَل،سَهلة	easy, convenient
سَهَل،سُهول	plain, field, level ground
سَهْل،سَهْلة،سهال	easy
سَهَم،أَسهُم/سِهام	arrow, share/stock (in company)
سوء	evil, badness
سَوا	flaw, even, together
سَواد	blackness
سوارة،أَساوَر	bracelet, bangle
سواقة	driving
سُؤأَل،أَسئِلة	question
سؤال،أسإلة	question
سَوالَف	sideburns, side whiskers, sidelocks, sidecurls
سَواهي	from the root س ـ ه ـ ي denoting inattention or negligence
سور،أَسوار	wall
سورة،سُوار	sura, chapter of the Qur'an
سوري	Syrian
سوريا/سورِيّا/سورِيّة	Syria
سوس	liquorice
سوق،أَسواق	market
سوق،أسْواق	market
سَوى مَرّات	often
سويْد،الْسّويْد	Sweden
سويْدي	Swedish, Swede
سويسرا	Switzerland
سويسري	Swiss
سياج	fence, hedge
سِياحة	tourism
سِياحي	tourist-, touristic
سِيادة	sovereignty, respectful form of address
سَيّارة	car
سَيّارة،سَيّارات	car
سِياسة	politics
سِياغة	goldsmithery, silversmithery
سِياق	course, context
سيبة	double sided ladder, builder's stepladder
سيخ،سياخ	skewer, knitting needle, kitchen knife (someplaces)
سَيِّد	sir
سيد،أَسياد	master, lord, sir, grandfather
سَيَّد،سادة	Mr., mister, master, lord, gentleman
سَيِّدة	lady
سيْر	motion, course, progress, traffic
سيرة	story, take, matter, topic, subject
سَيطَرة	domination, control
سيغارة،سِغايَر/سَواغير	cigarette
سيْف،سيوف	sword
سيناء	Mount Sinai
سينَما	cinema
سَيَّئ	bad, evil
شائَع،شائعة	common, widespread
شابّ،شابّة،شَباب	young person
شابّة	girl, young woman
شادَر،شَوادَر	tarpaulin, canvas cover
شارَع،شَوارَع	street
شارِع،شَوارع	street
شاري	buyer, purchaser
شاز،شَوازّ	irregular, unusual, exceptional
شاش/شاشة	muslin (fabric), gauze, screen?
شاطَر،شَطرة	smart, clever, bright, quick, hard working, successful
شاطِر،شاطْرة،شاطْرين	clever, smart
شاعَر،شُعَراء	poet
شافِعي	shafi'ite
شاقّ	hard, difficult, heavy
شاكوش،شَواكيش	hammer
شاكوش،شَوَاكيش	hammer
شامة	mole (on face etc)
شامَل	comprehensive, complete, total, general
شامِل،شامْلة،شامْلين	comprehensive, broad, complete, total, general
شأَن/شان،شُؤون	affair, matter, business
شاهَد،شَواهَد	tombstone (on Muslim grave)
شاهَد،شهود	witness
شاي	tea
شايَب	grey haired
شايَع	spread, having spread
شايَف	arrogant, pretentious
شايِف،شايِفة،شايِفين	seeing (act)
شَب/شاب،شَباب/شُبّان	youth, boy, young man, young
شَباب	youth, youthfulness, young days, youth (coll), young men
شِبّابة	reed flute
شباط	Februrary
شُبّاك،شَبابيك	window
شِبَر،أَشبار/شبورة	span, handspan, roughly 20cm
شِبرِيّة،شَباري	dagger (about one شِبَر in length)
شَبعان	full, satisfied, replete, sated
شَبَكة،شباك/شَبَكات	net, network, shopping basket
شِبَل،أَشبال	(lion) cub
شَبَه	resemblance, similarity
شُبهة	suspicion
شَبيبة	youth (coll), young people
شبين،شَبايَن	best man / bridesmaid (wedding), godfather
شِتا	winter
شِتاء	rain, winter
شَتَل/شَتلة،أَشتال/شَتلات	seedling, sapling, young plant
شَتَم	cursing, insults, abuse
شَتمة	a curse, an insult
شَتوة	shower (rain)
شَتَوي	winter- (adj), wintery
شَتوِيّة	winter (a specific winter)
شُجاع	courageous, brave
شَجاعة	bravery, courage (mainly in battle or dangerous situations)
شَجَر	tree(s)
شَجَرة،شَجَر\شَجَرات	tree
شُحّاطة	matches
شُحبار	soot, smut, black (noun), signs of burning
شَحطة	line, graduation, dash
شَحطة،شَحطيْن	stripe, two stripes (mil)
شَحَم	fat, grease
شَحمة	a piece of fat
شَحَن	loading, freighting, shipment, haulage
شَحنة	cargo, load, freight, (explosive) charge
شَحويْطة،شَحاويط	pair of mules, slippers
شَختورة،شَخاتير	boat (esp. in Galilee and Lebanon)
شَخْص،أشْخاص	person
شَخصي	personal, private
شَخصِيّاً	personally
شَخصِيّة	personality
شخير	snoring
شِدّة	strength, force, strictness, severity, tough line, trouble, sorrow, misfortune, adversity
شَدّة	this thing --> ــّـ, pack of cards, deck of cards, game of cards, false teeth
شَدّة،شَدَّات	deck of playing cards
شَديد	intense, strong, powerful, forceful, severe, strict, harsh, tough
شُذوذ/شُزوز	eccentricity, irregularity, deviation, exception
شَرّ	evil, badness, wickedness
شِراء	buying, purchasing, purchase
شَراب	soft drink
شَرار	sparks
شَراسة	roughness, harshess, brutality
شِراع،شروع	sail
شراك	very thin bread baked on a saj
شَراكة	partnership, cooperation, collaboration
شُرب	drinking, smoking
شَرح	explanation, elucidation, commentary
شِرَح/شِرحة،شِرحين	glutton, greedy person
شِرَس،شِرسة،أَشراس	violent, aggressive, brutal
شِرش،شروش	root, vein, nerve (some areas)
شَرشَف،شَراشَف	bed sheet, bedsheet, tablecloth
شَرشَف،شَراشِف	sheet, bedsheet, tablecloth
شَرشوبة،شَراشيب	fringe, tassel
شَرشوح،شَراشيح	scarecrow
شَرط،شروط	condition
شُرطة	police
شُرطي	cop, policeman,
شَرَع	(the) law (in general)
شَرعي	legal, legitimate, based on Islamic law
شَرَف	honor, respect, self-respect
شَرَّفنا	please come in / pay us a visit soon (honor us with a visit)
شَرق	east
شَرقي	eastern, east-
شِرك	polytheism
شِركة،شَرِكات	company, firm (business)
شِرْكة\شَرِكة،شَرِكات	company, firm
شَركَسي	Circassian
شَرموطة،شَراميط	sex worker, prostitute, slut, whore
شِروال،شَراويل	a type of pants wide around the hips and narrow at the ankles, worn mostly by old men
شَروة	purchase, buy
شِريان،شَرايين	artery
شَرّيب	drunkard
شَرية	(skin) rash
شَريحة،شَرايَح	long slice, slide
شريط،أَشرِطة	tape, strip, band, ribbon, film
شريطة،شَرايَط	duster, cloth, rag
شَريعة	Sharia (Islamic canonical law)
شَريف،شُرَفاء	noble, high ranking, self respecting, honorable, respectable, proper, fair
شريك،شُرَكاء	partner, companion
شَطّ،شطوط	beach, shore, coast
شَطَبتهُ	I took it off the list, I crossed it off
شَطحة	excursion, trip, picnic
شَطرَنج	chess
شِعار	slogan
شُعاع،أَشِعّة	ray, beam
شَعانين	palms
شَعْب،شُعوب	people
شَعبان	the eighth month of the Muslim year
شُعبة،شُعَب	branch, bough (esp. if it forks in two), catapult (قدس), bronchus, bronchial tube, branch (of bank etc)
شَعبِيّة	popularity
شَعَر	hair
شِعَر،أَشعار	poetry, poem
شُعَر،شعور	crack
شَعرة	one hair
شَعْرة،شَعْر\شَعْرات	hair
شِعري	poetic, poetry- (adj)
شَعرِيّة	thin noodles, vermicelli, fine netting
شَعشَبون	cobwebs, spider webs
شُعور	feeling(s), sentiment, perception, awareness
شُعوري	conscious
شعير	barley
شَعيرة،شَعائَر	religious rites
شَغّال	working, busy, occupied, in action, in motion, running
شُغُل،أَشغال	work, labor, occupation, business, concern, matter
شُغْل،أَشغَال	work, job
شَغلة	job, occupation, issue, concern, affair, matter, thing
شِفاء	cure, healing
شَفّاطة	plunger, vacuum cleaner
شَفّاف	transparent
شِفّة،شَفايَف/شفاف	lip
شَفتورة،شَفاتَر	thick lip
شَفرة	blade (of knife, razor, etc), rubber blade of a windscreen wiper
شَفَقة	mercy
شَفَهي	oral
شُفير،شُفريّة	driver
شَقاوة	naughtiness
شَقّة،شُقَق	apartment, flat, area, neighborhood, part, section
شَقحة،شَقحات	slice, a slice
شَقفة،شُقُف	piece, slice, plot, babe/doll (of good looking women)
شَقلوب،بِالْشَّقلوب	upside down, inside out
شَقي،أَشقِياء	mischievious/naughty child, imp, little rascal, little monkey
شَقيق،شَقايَق/شَقائَق	(full) brother, anemone, crowfoot (plant)
شَقيقة	(full) sister
شَكّ	cheque / check
شَكّ،شُكوك	doubt, distrust, suspicion
شُكْر	gratitude
شَكشوكة	a dish made from spiced peppers, tomatoes, and eggs fried together in olive oil
شِكْل	type, kind
شَكْل	way, manner, form, shape, appearance, aspect
شِكَل،أَشكال	form, shape, appearance, aspect, way, manner, kind, type
شُكُلاطة	chocolate
شَكلة	brooch or flower worn for decoration
شَكلي	formal, fictitious
شَكوة،شَكاوي	complaint
شَلّال	waterfall
شَلَبي	beautiful, handsome, fine (weather)
شِلّة	belt saw, band saw
شَلطوفة،شَلَطيف	thick fleshy lip
شَلَل	paralysis
شلون	how? (Syrian word)
شَمّ	smelling
شَماتة	gloating over another's misfortune
شَمّاس	deacon, cantor
شماغ	(red) keffiyeh
شْمال	left (direction)
شَمال/شِمال	north, and, when you look east to the rising sun, the north is on your left (so left too)
شَمالي	northern
شَمّالي	left-handed
شُمّام	melon
شَمّة	smelling, sniffing, a snort (eg of an inhaled drug)
شَمتان	gloating, gloater (esp. over the misfortune of others)
شَمْس	sun
شَمسِيّة،شَماسي	umbrella, sunshade, parasol
شَمْسِيّة،شَمَاسي	umbrella
شَمَع	wax, candles
شَمعة،شَمعات/شَمَع	candle(s) (collective (final) form is used when no specific number is mentioned)
شَمَعدان	candlestick, candleholder
شِمَنتو	cement (f)
شَمَندَر	beetroot
شَنَب	mustache
شَنتة،شَناتي/شُنات	suitcase, bag, satchel
شَنتيرة	splinter (in القدس), a big lump of a girl (in الجليل), okay
شَنص	(good) luck, haphazardly, at random (from french/english)
شَنْطة،شَنْطات\شَناطي	bag
شِنَع،أَشناع	ugly, unattractive, plain
شَنغَل	hook
شَهادة	certificate, diploma, testimony, evidence, the Muslim profession of faith, martyrdom
شَهْر،أشْهُر\شْهُوْر	month
شُهرة	reputation, fame, good name
شَهري	monthly
شَهوة	desire, passion, lust
شَهِيّة	appetite, desire
شَهيد،شُهَداء	martyr
شَهير	famous, well-known
شَهيق	inhalation, breathing in
شَوارَب	mustache, mustaches (a plural)
شَوّال	the tenth month of the Muslim year
شوال،شوالات	sack
شوب	intense heat
شوبَك،شَوابيك	rolling pin
شورَبة	soup
شوشَرة،شَواشَر	commotion, uproar, racket, disturbance
شوف	seeing, sight
شوفة	sight, vision
شَوق،شوق	longing, yearning, desire
شوكة،شوك،شُواك	thorn, fishbone, fork
شَوْكة،شُوَك	fork
شومَر	fennel
شُؤوم/شوم	bad luck, evil omen
شَوي	roasting, grilling
شْوَّي	a little
شَيء،أَشياء	thing
شَيّال	brace, suspender, shoulder strap
شيْت	belonging to (in Jerusalem and Jaffa)
شيخ،شيوخ	old man, elder, patriarch, notable, sheikh, chief, leader
شَيخوخة	old age
شيد	whitewash, limewash (in some areas)
شيطان،شَياطين	devil, demon, evil spirit
شيعة	faction, sect
شيعي،شيعة	Shi'a, Shiite, Shia
شيفرة	code, cypher
شيْك	check, cheque
شيْكَل،شَواكَل	shekel
شيْلة	completely, totally, utterly, altogether, at all (in negative) (Galilee word)
شيوعي	communist
صابون	soap
صابونة	piece of soap, kneecap
صاج	tin (metal), bodywork (vehicle), domed sheet of tin on which Arabic bread is baked
صاحِب،صاحْبة،صْحاب	friend
صاحَب/صاحبة،أَصحاب/صاحبات	friend, companion, owner, proprietor, possessor
صاحبة	friend, companion (f)
صاحي	awake, aware, alert
صادة	echo, rust
صادِق،صادْقة،صادْقين	truthful
صادَق/صادقة	genuine, sincere, truthful
صاطور	cleaver
صاعَد/صاعِدة،	on the way up, rising, up and coming
صافِن،صَافْنة،صَافْنين	preoccupied
صافَن/صافنة	thinking, deep in thought, thoughtful, dreamy, preoccupied
صافي	net (of income), pure, unadulterated, clear
صالة	hall, reception room, drawing room, living room
صالَح	interest
صالَح	good, suitable, valid
صالِح،صالْحة،صالْحين	suitable
صالون	salon, living room
صامَت	silent
صامَد	standing firm, holding on
صايَغ،صُيّاغ	goldsmith, silversmith
صايَم	person who's fasting
صَبابة	great, wonderful
صَباح	morning, forehead (Galilee?)
صَباح الخير	Good morning
صَباح النور	Good morning
صُبُح	morning
صَبَر	patience, cactus, prickly pear
صَبَغ	dyeing
صَبَغ،صَبغة،أَصباغ	dye
صَبور	patient (adj)
صَبي،صِبيان	boy, young man
صَبي،صِبيان	child (m)
صَبِيّة،صَبايا	girl, young woman (12 and over)
صَحّ	right! true!
صَحافة	journalism, the press
صَحافي،صَحافِيّة،صَحافِيّة\صَحافيّات	journalist
صَحّة	health, soundness, rightness, correctness, authenticity
صَحْتين	Your health!
صَحراوي	arid, desert- (adj
صَحرة/صَحراء،صَحاري	desert
صُحُف	newspapers, the press
صُحُفي	journalist, journalistic, press
صَحَن،صحون	plate, dish
صَحِن،صْحون	plate, saucer
صَحو	fine weather (clarity)
صَحّي	healthy, health-related, sanitary, hygenic
صَحّيْتهُ	I woke him
صَحيح	true, right, correct
صحيح،صحيح	straight, flat, smooth, unwrinkled, whole, complete
صَخر	rock (material)
صَخرة،صخور	rock, boulder
صَخري	rocky, stormy
صُداع	headache, migraine
صَداقة	friendship
صَدر	chest, breast
صَدري	chest (adj), pectoral
صُدَغ،أَصداغ/صداغ	temple (side of forehead)
صَدَف	oyster (and other shellfish), mother of pearl
صَدَفة	an oyster, a shellfish
صُدفة	chance, coincidence, unexpected occurrence
صَدَفي	pearly, nacreous
صَدَقة	charity, alms
صَدمة	shock, blow (mental or physical)
صَديق،أَصدِقاء،صَديقة،صَديقات	friend
صَراحة	frankness, plain speaking, sincerity
صَرار	gravel
صَرّاف	money changer, spender
صرافة	money changing
صُرّة	bundle
صَرصور،صَراصير	cockroach
صَرف	inflection (grammar)
صَرَفوه	they fired him
صُرماية،صُرامي	pair of shoes (rare word)
صَروخ،صَواريخ	missile, rocket, firework
صَريح	sincere, frank, open
صَعَب،صعاب	difficult, hard
صَعِب،صَعْبة،صْعَاب	hard
صُعوبة	difficulty
صُعوبة،صُعوبات	difficulty
صُعود،عيد الْصّعود	ascension day (christian holiday)
صَعيد،الْصَّعيد	Upper Egypt (actually the South of Egypt, confusingly)
صِغَر	childhood
صْغير،صْغيرة،صْغار	small, young
صَفّ،صفوف	line, rank, class
صَفّ،صْفوف	class
صَفار	yolk
صَفّارة	siren
صَفافي	resident of Beit Safafa
صِفة	attribute, characteristic, trait, quality, distinguishing mark, adjective
صَفحة	page
صَفَحتيْن	two pages
صَفَد	Safad (town in Galilee, hometown of Mahmoud Abbas)
صَفَر	second month of the Muslim year
صِفر	zero
صُفرة	dining table
صَفَري	hepatitis, jaundice
صَفطة	pile, heap
صَفقة	deal (noun)
صَفوة	ash
صُفّيْرة،صَفافير	whistle
صَقر،صُقور	hawk
صَقل	polishing, burnishing, cutting (diamonds)
صَلاة،صَلاوات	prayer
صَلاة،صَلوات	prayer
صَلاحِيّة	authority, jurisdiction
صَلاحِيّة،صَلاحِيّات	authority
صُلَب	hard, rigid, firm
صُلح	peace, cessation of hostilities, reconciliation
صُلحة	reconciliation ceremony
صَلَع	baldness
صَليب،صُلبان	cross
صَليبي	crusader
صَمّ	deafness
صَمّام	valve
صَمت	silence
صَمدة	bridal podium (used mainly by Muslims from Galilee
صَمَغ	glue
صُمود	standing firm, holding on, persistence (in times of trouble etc)
صَمّولة/صَمّونة،صَماميل/صَمامين	nut (for screwing onto a bolt)
صَميم	core, innermost recess
صُنّارة،صَنانير	hook
صِناعة	industry
صِناعي	industrial, industrialized
صَنج،صنوج	cymbal
صَندَل،صَنادَل	(pair of) sandals)
صُندوق،صَناديق	box, crate, fund
صَنْدوق،صَناديق	cash register
صُنُع	production, manufacture
صَنعة،صُنَع	craft, trade, skill, vocation
صَنَم،أَصنام	idol, statue
صنوبَر	pine nuts
صَنِيّة	tray
صَنِيّة،صَواني	round tray
صَهيل	neigh, whinny
صَهيوني،صَهاينة	zionist
صَواب	rightness, correctness, the right thing, mind, sense, reason
صُوّانة	a piece of flint
صوت،أَصوات	voice, sound, noise, vote
صوت،أصْوات	voice, sound, vote
صورة،صُوَر	picture, photo, form, shape, manner
صورَة،صور	picture
صوص،صيصان/صوصان	chick
صُوص،صِيصان	chick (baby chicken)
صوف	wool
صوفة	sofa, couch
صوم/صيام	fast, fasting (noun)
صياح	shouts, shouting, uproar
صَيّاد	hunter, fisherman (depends on context)
صياغة	goldsmithery, silversmithery
صِيانة	protection, conservation, safeguarding, maintenance
صيت	reputation, good/bad name
صيْد	hunting, fishing
صَيدَلة	pharmacy (profession)
صَيدَلي،صَيادلة	chemist, pharmacist
صَيدَلِيّة	pharmacy, drugstore
صيغة	form (grammar etc), jewellery
صيغَتها	her jewellery
صيف	summer
صيْفي	summer (adj), summery
صين،الْصّين	China
صيني	Chinese, porcelain
ضابِط،ضابْطة،ضابْطين	officer
ضامة	draughts, checkers
ضان	mutton
ضايَع،ضايعة،ضايَعين	lost
ضَباب	mist, fog
ضَبان	insole (shoe)
ضَبط	control
ضَبَع،ضباع/ضبوعا	hyena
ضَجّة	noise
ضُحكة	(the sound of) laughter, laughing matter
ضَحِيّة،ضَحايا	victim
ضَخَم،ضخام	enormous, huge
ضِدّ/ضَدّ/ضُدّ	against
ضَرب	hitting, beating, shelling, bombing, multiplication
ضَربة	(a single) blow/hit
ضَربة،ضَربات	a [single] hit, a [single] blow
ضَرّة	second/additional wife
ضَرَر،أَضرار	damage
ضَرَر،أضْرار	harm, damage
ضَرطة	fart
ضَرورة	necessity
ضَروري	necessary
ضَريبة الدَخْل	income tax
ضَريبة،ضَرايَب	tax
ضَريبة،ضْرايب	tax
ضُعف	weakness
ضَعف،أَضعاف	twice/several times as much, -fold
ضَعيف،ضعاف	weak, thin
ضَغط،ضُغوط/ضُغوطات	pressure, tension
ضَغينة	grudge, ill will, spite
ضَفّة،ضِفاف	bank (of a river)
ضَفّة،ضْفاف	riverbank
ضَفدَعة،ضَفادَع	frog
ضُفر	fingernail
ضَفيرة،ضَفايَر	plait, braid
ضِلَع،ضلوع/ضلاع	rib, part/side/role
ضَمان	guarantee
ضُمّة،ضُمَم	bouquet, bunch
ضُمّة،ضُمَم	bundle
ضِمن	within/inside/among
ضَمير،ضَمائَر	conscience, pronoun
ضَهَر	back
ضُهر	noon
ضَهْر،ضُهور	back (body)
ضُهْر\ظُهْر	noon
ضَوّ،أضوِية	light
ضَواحي	surroundings, outskirts, suburb
ضَوي	lighting
ضَيّ	light, traffic light
ضَيان	durable, long lasting
ضَيعة،ضِيَع	village
ضَيف،ضيوف	guest
ضيف،ضْيوف	guest
ضَيَّق	narrow
ضيق/ديق	distress, trouble
طابة	ball
طابَع،طَوابَع	[postage] stamp
طابِع،طَوابِع	stamp
طابِعة	printer
طابَق،طَوابَق	storey, floor
طابو	land registry office
طابون،طَوابين	small domestic baker's oven (outside of house)
طاحون/طاحونة،طَواحين	mill, millstone, molar (tooth)
طاحونة،طَواحين	molar, mill
طار،طَئر	vengance, revenge
طارَئ،طَوارِئ	unexpected, exceptional, emergency, unexpected event
طازا	fresh (doesn't decline for gender)
طازة	fresh
طاشة	bowl, cup, helmet
طاشَش/طاشّة،طاشّين	out wandering around
طاغي/طاغِية،طُغاه	tyrant, despot
طافَش/طافشة	roaming, rambling, meandering, wandering around
طاق	a single layer/fold
طاقة	energy, force, strength, power, ability
طاقَم	team
طاقِيّة،طَواقي	cap, hat, skullcap
طَاقِيِّة،طَوَاقي	cap
طالَب،طُلّاب	student, pupil
طالبة،طالِبات	student, pupil
طالَع	coming out, going out, going up, taking after
طالِع،طالْعة،طالْعين	going out/up (act)
طالَما	because, since, as, as long as
طاهَر/طاهرة	pure
طاولة	table
طاوْلة،طاوْلات	table
طائَر	flying
طايَر،طَوايَر	tyre (from english)
طائِرة	plane, aeroplane, airplane (more formal)
طايَش/طايشة،طايشين	irresponsible, unreliable, scatterbrained, rash
طايفة/طائِفة،طَوايَف/طَوائَف	(religious) community, denomination, sect
طائِفِيّة	sectarianism
طَب	well.. (short)
طِبّ	medicine (profession)
طَبّاخ	chef, cook
طَبّاخ،طَبّاخة،طَبّاخين	cook, chef
طِباعة	printing, typography, typing, keyboarding
طُبّة،طُبَب	ball (of string, wool, etc)
طَبَخ	cooking
طَبخة	dish, course (food)
طَبشورة،طَباشير	(a piece of) chalk
طَبَع	nature, character, printing
طَبعاً	of course, naturally
طُبعة	sticker
طَبعة	printing, edition
طَبَق،أَطباق	large round tray made of stray or wicker
طَبَقة	layer, stratum, social class, storey (of building)
طَبَل،طبول	drum
طَبلة	drum
طِبّي	medical
طَبيب	(medical) doctor
طَبيب،طَبيبة،أطِبّا	doctor
طَبيخ	dish, course, cooking, cookery
طَبيعة	nature
طَبيعي	natural, normal
طحال	spleen
طحين	flour
طحينة	tahine (paste made from ground sesame seeds)
طِراز حَديش	a new model, a modern style
طِراز،طُرُز	model, style, class, type, brand
طَرَب	music, singing
طَربوش،طَرابيش	one of those turkish hats?
طَرَح	subtraction
طُرُح	miscarried fetus, aborted fetus
طَرحة	veil
طَرحِيّة،طَراحي	sheet of paper, page
طَرد،طرود/طرودة	parcel, package, swarm
طَرش	mixed flock/herd of both large and small animals
طَرَش	deafness
طُرطيْقة	rattle (toy)
طَرَف،أَطراف	edge, side, party, side (in conflict etc)
طَرَف،أطْراف	extremity, bias
طرُمبة	pump
طَري	soft
طَرّيش	whitewasher (inالقدس)x
طَريق،طُرُق	way, road, track, highway, route
طَريق،طُرُق	way
طَريقة،طُرُق	way, method, system
طُزّ	so what! who cares!
طُشت،طشوت/طشوتة	bowl, basin (for laundry)
طَطلي/طَطلة،طَطالي	jam, jelly
طَطْلي\طَطْلة،طَطَالي	jam, jelly
طَعام	food
طُعُم	bait
طَعَم،طَعمة	taste, sense, reason
طَعْم\طَعْمة	taste (food)
طَفّاي	fire extinguisher
طَفران	penniless, broke
طُفطاف	low wall around the edges of a flat roof, raised area of a flat roof
طِفَل،أَطفال	young child, toddler
طُفولة	childhood
طَقّاشة	stapler
طَقس	weather, religious rite, ritual
طَقَم،طقومة	set, uniform
طَلاق	divorce
طَلَب	request, demand, order
طَلعة	ascent, climb, going out, departure
طَلَق	contractions, labor pains
طلوع	coming out, going out, rising
طَلياني	Italian
طَمبون	bumper (vehicle) (from french)
طَمَع	greed
طَموح	ambitious
طَمّيع/طَّاع	greedy, grasping
طُنّ/طون،أَطنان	ton
طَنجَرة،طَناجَر	cooking pot
طُنَطلة	vulva
طَنطور	tall hat, hood (of jacket etc)
طنَعش	twelve
طَهارة	purity
طُهُل/طُحمُل/طُحمُر	coffee grounds
طهور	circumcision
طَواف	circuit, round trip, circumambulation of the Kaaba during Hajj
طَوّالي	straight away, at once
طوب	bricks, concrete blocks
طوبار	form(s) (moulds) for pouring concrete
طوبَرجي	moulder, one who makes moulds for concrete
طور	Aramaic word for mountain
طوري،طَوَرا	a person from al-Tur
طوشة	fight, brawl, quarrel
طوفان	deluge, downpour, flood
طوق،طواق	collar (for animal etc)
طول	length, height
طولة	length
طَويل،أَطوَل	long, tall
طَويل،طْويلة،طْوال	tall
طَيّارة	aeroplane,plane, airplane, kite
طَيّارة،طَيّارات	airplane, kite
طَيَّب	good, fine, tasty, alive
طيبة	goodness, kindness
طيْر،طيور	fowl, bird
طَيران	flying, mad about, crazy about
طيز	ass
طين	clay
ظابَط،ظُبّاط	officer
ظاهَر،ظَواهَر	perceptible, visible, outward appearance
ظاهِرة،ظَواهَر	phenomenon, appearance
ظَبط	exactness, precision, control
ظَرف،ظُروف	envelope (some areas), circumstance
ظَلّ	shade, shadow (فَيّ more common)
ظَلام	darkness, dark
ظَلط	nudity, nakedness
ظُلُم	injustice, oppression
عابَس،عابسة	frowning, scowling, looking angry
عابَط،عابَطة	hugging
عاتَق،عَواتَق	shoulder
عاجَز،عاجزة	disabled, incapable
عَاجَل	fast, speedy
عاجِلاً	quickly, at once, immediately, soon
عاد	come on, get on with it
عادة،عادلت،عَوايَد	custom, habit
عادة،عادات	habit, custom
عادَتًا	usually
عادَل،عادلة،أَعدال	just, fair
عادي	usual, common, it's alright
عار	shame, disgrace, dishonor, stigma
عارَض،عارِضة	proposer, demonstrator, exhibitor
عارضة،عارضات	rung (of a ladder)
عاشَر	tenth
عاشَق،عُشّاق	lover, in love with, mad and crazy about
عاصفة،عَواصَف	storm
عاصم،عَواصِم	capitol
عاطِفة،عَواطَف	emotion, feeling
عاطِفي،عاطِفِيّة	emotional, sensitive
عاطِفِيّة	sentimentality
عاطَل،عاطلة،عاطلين	bad, nasty
عاطِل،عاطْلة،عاطْلين	nasty
عافية	health, vitality, wellbeing
عاقَر	barren, sterile
عاقَل،عاقلة،عُقال،عاقِلين	intelligent, wise, sensible
عاكَس	reflector
عال	great! wonderful!
عالْرّيق	on an empty stomach (on the saliva)
عالقَليلة	at least
عالِم	scientist
عالَم،عالمة	knowing, aware
عالَم،عالَمين	world
عالَمي،عالَمية	global, worldwide
عالي،عالية،عاليين	high
عامّ،عامّة	general, public
عامَر	thriving, flourishing, full of life
عامَل،عاملة،عُمّال،عامِلات	worker, laborer
عامَل،عَوامَل	factor
عامِل،شَغّيل،عُمّال،شَغّيلة	worker
عامِل،عَامْلةْ،عامْلين	working
عامِل،عَوامِل	cause, factor
عامّي،عامِّيّة	common, popular
عاهة،عاهات	disability, defect
عايِش،عايِشة،عايِشين	living
عُبّ	bosom, breast pocket (more precisely, the place between the garment and the chest)
عَباية	cloak like woollen coat with wide sleeves worn by country people or bedouins
عُبراني،عُبرانِيّة	hebrew
عِبرة،عِبَر	lesson, moral (of a story)
عَبري،عَبرِيّة	hebrew
عَبقَري،عَبقَرِيّة	genius
عُبْوة	explosive charge
عُبوة،عُبوات	charge (like an explosive charge), container, package
عَبيط،عَبيطة	stupid, foolish
عَتّال،عَتّالين	porter
عَتَبة،عَتَبات	threshold
عِتّة	moth
عَترة	obstacle, stumbling block
عَتَلة	crowbar
عِتَم،عِتمة	dark
عَتمة	darkness, dark (noun)
عَتيق عَتيقة،عُتَق\عُتاق	old
عَتيق،عَتيقة،عُتُق،عُتَق،أَعتاق	old (things, not people)
عَجَر	unripe
عَجَز	weakness, disability, deficient
عَجَل،أعجال	wheel, tyre
عِجَل،عِجَلة،عجول	calf (young cow/bull)
عَجَل،أعْجال\عِجال	wheel
عَجَلة	haste, hurry
عَجَمة،عَجَمات،عَجَم	stone, kernel, pit (fruit)
عَجَمي،عَجَمِيّة	Persian (usually carpets)
عَجوة	pressed dates
عَجوز،عَجايَز	old woman
عَجِيب،عَجِيبة	surprising, astonishing, amazing, wonderful
عَجيبة	wonder, miracle, marvel, strange/odd thing
عَدّ	counting
عَدا،ما عَدا	except, apart from
عَدّاد	meter (gas meter etc)
عَدالة	fairness, honesty
عَداوة	hostility, enmity
عَدائي	hostile
عِدّة	tools, instruments
عِدّة	several, a number of
عِدّة	the period of time which must elapse before a divorced or widowed muslim woman may begin a relationship with another man (90 days for a divorcee, 120 for a widow)
عِدّة،عَدَد	number
عَدَد،أعداد	number
عَدَسة،عَدسات،عَدَس	lentil, lentils, lens
عَدَل	justice
عَدَم	absence, lack, shortage
عَدوَ	epidemic
عَدُوّ،أَعداء	enemy
عُدوان	aggression, aggressiveness
عُدواني،عُدوانِيّة	aggressive, hostile
عُدوي،عُدوِيّة	organic
عُدوِيّة	membership
عَدِيد،عَدِيدَة	numerous
عَديل	husband of one's wife's sister, brother in law
عَديم	lacking, without, -less, un-, etc
عَذرة	virgin
عَرّاف،عَراريف	branch
عَرّاف،عَرّافة	fortune teller
عَربون،عَرابين	pledge, deposit, guarantee
عَربي،عَرَبيّة،عَرَب	Arabic
عَرَبِيّة،عَرَباي،عَرَبة،عَرَبَيّات	cart, carriage, supermarket trolley
عُرَس،أَعراس	wedding
عَرش،عُروش	throne
عَرص،عَرايَص	pimp, swine, bastard
عَرْض	beadth, width
عَرَض،أَعراض	sign, symptom
عَرض،عُروض	display, show, supply
عَرف	crest, comb
عُرف،أعراف	convention, usage, accepted behaviour
عُرف،عُروف	branch
عَرَق	sweat, perspiration, arak
عِرق،عُروق	root, stem
عَرقان،عَرقانة	sweating
عَرقَلة،عَرَقيل	obstacle, hinderance
عِروة	buttonhole
عَروس،عَرايَس	bride
عَروسة	doll
عَريان،عَريانة،عَرانين	naked
عَريس،عُرسان	bridegroom
عَريشة،عَرايِش	pergola, roofed grapevine trellis next to the house
عَريض،عَريضة	wide
عَريض،عَريضة،عْراض	broad
عَريضة،عَرائض	petition
عَريف،عُرَفا	corporal
عِزّ	climax, might, power
عَزاب	suffering, anguish
عَزّابي،عَزّابِيّة،عَزّابِيين،عُزبان	single, unmarried
عَزارة	reprimand, rebuke
عِزَة	power, might, glory, (sense of) honor
عُزُر،عُذر	excuse, good reason, justification
عَزَقة،عَزَقات	nut (for a screw/bolt)
عِزوة	support from one's family and friends, support network
عَزيز،عَزيزة،عَزيزين	dear, precious, loved, beloved
عَزيز،عَزيزة،عَزيزين	dear
عَزيمة،عَزايَم	invitation
عَسكَر	troops, soldiers
عَسكَري،عَسكَرِيّة	military (adj), soldier
عَسَل	honey
عَسَلي،عَسَلِيّة	honey colored, light brown
عَشا	supper, evening meal, evening prayer
عِشاء	time of evening prayer
عَشان\عَلَشان	because of
عِشَب،أَعشاب	grasses
عَشبة	bandage
عِشة	life, way of life, lifestyle
عِشتُم	thank you (for the invitation)! (may you live)
عُشَر،أَعشار	(a) tenth
عَشَرة،عَشْر،عاشِر	ten
عُشرَين	two tenths
عَشوائي	arbitrary, random
عشيادة،عشيادات	clinic
عَشِيّة	evening
عَشيرة،عَشائَر،عشايَر	tribe, clan
عَشيرة،عَشائِر	tribe, clan
عَشيق	lover
عَصَا،عُصي	stick, rod, staff
عِصابة،عِصابات	gang
عُصابي	neurotic, nervy
عُصابِيّة	neurosis
عَصّارة،عَصّارات	press, lemon squeezer, wringer, mangle
عَصَب،أَعصاب	nerve
عَصَبي،عَصَبِيّة	nervous
عَصَبِيّة	touchiness, irritability, oversensitivity
عَصة	stick
عَصَر	squeezing, pressing (fruit olives etc)
عَصَر	age epoch
عَصَر	late afternoon, the afternoon prayer
عَصري	contemporary, modern
عَصفور،عَصافير	small bird
عَصيان	disobedience, rebellion, revolt
عَصير	juice, squash
عَضَلة،عَضَلات	muscle
عَضَم	bone (substance)
عَضمة،إعضام	bone
عَطّار،عَطّارين	perfume vendor, spice merchant
عُطَر،عُطور،عُطورات	perfume, scent
عَطَش	thirst
عَطشان،عَطشانة	thirsty
عُطلة	holiday, day off
عَطيلة	burden
عَظيم،عَظيمة،أَعظام،عُظما	large, huge, great, powerful
عَفش	possessions, household effects, furniture
عَفو	amnesty, forgiveness, pardon
عَفْوًا	excuse me
عِقاب،عِقابات	punishment
عَقاقير	drugs, medicines
عَقال	headband, cord (keeps keffiyeh in place)
عُقبال	may it be the same for, I wish the same to...
عَقَبة،عَقَبات	obstacle, hinderance, difficulty, pass, steep mountain road
عَقَد	arch, vaulted ceiling, contract
عُقُد،عُقودة	necklace
عُقدة،عُقَد	knot, complex, inhibition, hang up
عَقرَب،عَقارَب	scorpion, hand of a clock
عَقَل	mind, sense, reason
عَقل،عْقُوْل/عَقْلَاْت	intellect
عَقلِيّة	mentality, way of thinking
عُقوبة،عُقوبات	penalty, sentence, (legally imposed) punishment
عَقيد،عُقَدا	colonel
عَقيم	sterile, barren, unproductive
عَكّا	Acre
عُكّازة،عَكاكيز،عُكّازات	walking stick, crutches
عَكّاوي،عَكّاوية	person from Acre
عَكَر	sediment, dregs
عِكَر،عِكرة	muddy, turbid, cloudy (of a liquid)
عَكروت،عَكاريت	pimp, swine, bastard, creep
عَكس	opposite, contrary
عَكَفة،عَكَفات	hook
عَكّوب	cardoon (a type of edible thistle)
عِلاج	treatment
عَلّاقة،عَلّاقات	clothes hanger
عَلامة،عَلامات	sign, symbol, mark, grade (at school)
عَلامة،عَلامات	mark, school grade, sign
عُلبة،عُلَب	can, box, tin
عِلبة،عِلَب	box, tin, can
عَلَف	fodder
عِلكة	chewing gum
عَلَم،أَعلام	flag
عِلَم،عِلم	knowledge, science
عِلْم،عُلوم	science
عُلَما	scholars
عِلماني،عِلمانِيّة،عِلمانيين	secularist
عِلمانِيّة	secularism
عِلمي،عِلمِيّة	scientific
عِلمِيّاً	scientifically
عَلَني	open, public
عُلو	height
عَلَواه	let's hope so! I wish!
عَلَى خَطأ	mistaken
عَلى طول	straight ahead
عَلى فِكْرة	by the way
عَلَى كُلّ حال	anyway
عَلى،ع	on, upon, on top of
عَمّ،عْمَام	paternal uncle
عُمّاد	baptism
عَمار	building, construction, prosperity
عَمار،دايمة	[May it] always be
عَمارة،عَمارات	building
عَمارة،عَمارات	building
عَمّال،عَماميل	ox
عَمة	blindness
عُمْر	age
عُمُر،أَعمار	lifetime, life span, age
عُمري ما	never
عِملاق،عَمالِقة	giant, superpower
عَمَلان	making (verbal noun)
عُملة	money, currency
عَمَلي،عَمَلِية	practical
عَمَلِيّاً	in practice
عَمَلِيّة،عَمَليّات	operation
عَمود،عَواميد،أعمِدة،عُمدان	pole, pillar, column (journalism)
عَمود،عُمْدان	pillar
عَمودي	vertical
عُمولة	commission
عُموم	generality, whole
عُمومي،عُمومِيّة	general, public
عَميد،عُمَداء	general (military), dean (university), rector
عَميق،أَعمَق	deep, profound
عَميل،عُمَلاء	agent, collaborator, spy
عَن	about
عَن إذنك	excuse me
عِناية	care, concern
عِنَب	grapes
عَنبَر،عَنابِر	barn, granary, storehouse (for grain)
عَنزة،عَنزات،عَنز	goat
عَنَس،عَوانَس	single woman, spinster
عُنصُر،عَناصَر	race, breed, element
عُنصُري،عُنصُرِيّة،عُنصُريين	racist, racial
عُنف	violence
عُنُق،أَعناق	neck
عَنكَبوت،عَناكَب	spider
عُنوان،عَناوين	address, title, headline, heading
عُنْوان،عَناوين	address, title, headline
عَنيد،عَنيدة،عُنَدا،عَنيدين	stubborn, opinionated, headstrong, tough
عَنيد،عَنيدة،عُنَدا/عَنيدِين	stubborn
عَنيف،عَنيفة	violent
عَواقَب	consequences
عَوّامة،عَوّامات	floater
عود،أعواد	oud
عود،عيدان	branch, piece of wood
عَودة	return
عَون	help
عَوي	bark, barking
عَوّيد،عَوّيدة،عَوّيدين	oud player
عَويص،عَويصة	complex, complicated, difficult, obscure
عيار،عيارات	measure, gauge, standard, (a) weight
عيال	children
عِيال	(nuclear) family
عَيّان،عَيّانة،عَيّانين	ill, sick, not well, a patient
عَيب،عيوب	fault, defect, shame, disgrace
عيب،عْيوب	shame
عيرة	false, artificial (of a body part)
عيسى	Jesus
عَين،عَيون	eye, spring (water source)
عين،عينَين،عْيون	eye
عين،عْيون	eye
عَيِّنة،عَيِّنات	specimen, sample
غارة	attack, raid
غاز	gas
غافي	asleep
غافي	asleep
غالَب	winner, victor
غالي	boiled (a.p.)
غالي	expensive, dear, beloved
غالي،غَالية،غاليين	expensive
غامَض	unclear, obscure, enigmatic, concealed, mysterious
غامَق	dark (color)
غائَب	absent, absentee
غايَب	absent, away
غاية	goal, purpose, intention, end, limit, extremity
غَباش	opacity, murkiness, condensation
غَبَرة	dust
غَبي،أَغبِياء	stupid, fool(ish), simple-minded
غِتار	guitar
غَد	tomorrow
غَدا	lunch, midday meal
غَدا	lunch
غُدّة،غُدَد	gland
غُراب	crow
غرام	gram
غَرام	love, passion, infatuation
غَرامة	a fine
غَرامي	amorous, erotic, love-
غرِب	flu, influenza
غَرب	west
غُربة	exile, living abroad
غَرْبي	western, westerly
غُرّة	fringe (hair?)
غَرسون	waiter (from French)
غَرَض،أَغراض،غراض	object, objective, aim, purpose, commodity, object, thing
غَرَض،غْراض	commodity, object, thing, objective, aim
غَرغَرينة	gangrene
غُرفة،غُرَف	room
غُرفة،غُرُف	room
غَرَق	drowning
غَرقان	sunk, immersed, bogged down
غُرور	conceit, vanity, self-delusion
غِري	woodworking glue
غَريب،غُرَباء	foreign, alien, strange, unusual, extraordinary, strange
غَريب،غَريبة	strange
غرَيّبة	small cake in the shape of an S made of مَبسوس mabsus
غَريزة،غَرايَز	instinct
غَريق	drowned, a drowned person
غَزال،غُزلان	gazelle
غَزال،غَزالة،غُزلان	gazelle
غَزّاوي،غَزازوة	Gazan
غَزّة	Gaza
غَزل	spinning
غَزو	invasion
غَسّالة	washing machine, person who washes things
غَسيل	washing, laundry, developing (film)
غُش	fraud, deceit, swindle
غِشاء	cover, envelope, membrane
غَشّاش	swindler, fraud, cheat, impostor
غَشيم	inexperienced, ignorant
غُصن،غصون،أَغصان	branch
غَضَب	rage, fury, anger
غَطا،غُطي	lid
غطاس	immersion
غَطى،غُطي	cover, covering, lid
غطَيطة	fog, mist
غَفلان	absent minded, distracted, (some areas) asleep, drowsy
غُلّ	rancor, spite
غَلاء	high cost, high price
غَلّاية	kettle, coffee pot, boiling container
غَلبان	unfortunate, wretched, loser
غَلَبة	trouble, inconvenience
غَلّة	yield, harvest, produce, takings, revenue, proceeds
غُلّة،غلال،غلول	marbles
غَلَط،أَغلاط	mistake, error, wrong, incorrect
غَلَط،أغْلاط	error
غَلطان	wrong, mistaken
غَلطة	error, mistake
غَلَن	jerrycan
غَلَيان	boiling, unrest
غَليان	newly expensive, having gone up in price
غَليون،غَلايين	pipe (smoking)
غَمّاز	indicator (light), blinker, turn signal
غَمّازة	dimple
غُمّاي	blind man's buff
غُمرُك	customs
غَمزة	wink
غُمَّيضة	blind man's buff
غَميق،غماق	deep (literal)
غِناء	singing, song, wealth
غَندور	dandy, fop, show off
غَنَم	sheep (coll, sometimes includes goats)
غَنَمة	a single sheep
غَنّوج	self-indulgent
غَني،غُنَيا،غَنايا	rich, wealthy
غَني،غَنيّة،أغنيا	rich
غَوّاد	pimp
غَوّاصة	submarine
غوث/غَوث	help, aid
غور	vallet
غَوغا	noise, shouting, rabble, mob
غول	ghoul, man-eating demon
غول،غوال	goal (football)
غياب	absence, disappearance, setting (of sun etc)
غَيار	replacement, spare part, change of clothes, gear (on a vehicle)
غَيب	hidden, invisible, unknown, beyond human perception
غَيبة	absence, period of absence
غير	gear
غَير	except, apart from, other, another, else, different, un-, in-, dis-
غِيرة	jelousy
غَيض	small quantity
غَيم،غَيمة،غَيوم	cloud
غَيّور	jealous
فَ	then, so, hence, thus
فاتَح،فاتحة،فاتحين	open (of shop, etc)
فاتِحة،الفاتِحة	The Opening (first sura of the Qur'an)
فاتَر،فاترة	lukewarm
فاخَر	glorious, luxorious, fancy, grand
فار،فارة،فيران	mouse
فار،فيران	mouse
فارة،فارات	plane (carpenter's tool)
فارَغ،فارغة	empty, unoccupied, free
فارَق،فَوارَق	difference
فاريزة،فَواريز	comma
فاس،فوس	hoe
فاشَل،فاشلة	failed, unsuccessful
فاصَل،فاصلة	seperating
فاصلة،فَواصَل	comma
فاضي	empty, vacant, free, unoccupied
فاضي،فاضْية،فاضْيين	empty
فاكِهة،فَواكِه	fruit
فال	sign, omen
فالَت،فالتة	unattached, detached, free, loose, dissolute, wanton, loose
فالَج	partial paralysis (of one side of the body, or a particular limb
فِالمُدّة الأخيرة	lately
فانوس،فَوانيس	lantern
فاهَم	understanding (active part.)
فاهِم،فاهْمة،فاهْمين	understanding (act)
فايدة،فائِدة،فَوايَد،فَوائَد	benefit, advantage, interest, point
فائَز	winner, victor
فايَض،فايَظ	interest (on a loan)
فَتاة،فِتَيات	girl
فتّاح	fortune teller (opener)
فتاق	hernia, rupture
فَتّان	telltale
فَتّان،فَتّانة	charming, attractive
فَتح	opening, conquest
فِتَح،فِتحة،فِتحين،فِتحات	clever, bright
فَتحة	opening, slot, aperture, the vowel َ a
فَترة	period of time, a while
فَتفوتة،فَتافيت	crumb
فِتنة	charm
فَتورة،فَواتير	receipt
فَتوى،فَتاوي	fatwa, religious decree
فتيلة،فَتايَل	wick
فَجأَ	suddenly
فُجائي	sudden
فَجْأة	suddenly
فَجر	dawn
فَجعان	glutton
فِجل	radishes
فِجلة	a radish
فَجوة	gap, breach
فَحْص	examination
فَحص،فُحوص	test, examination, exam
فَحم	coal
فَخّ،فخاخ	trap, snare
فُخّار	pottery, earthenware
فَخد،فخاد	thigh
فَخر	pride, glory, magnificence, splendour
فَخم	luxury, splendid, magnificent, grand, fancy, classy
فَخور	proud
فِداء	redemption, ransom, sacrifice
فِدية	ransom
فراش	bed linen, bedding
فراطة	small change, unimportant, worthless
فَراغ	free time, liesure, emptiness, void
فَرّان	baker
فُرجة	sight, vision, spectacle
فَرَح،أَفراح	happiness, joy, gladness, family celebration
فَرحان	happy, glad
فَرخ،أفراخ،فراخ	chick, fledgling
فَرد،فرودة	pistol, gun, spray gun, hairdryer
فَردة،فَردات	one of a part, half of a couple
فَردي	individual
فَرسي	Persian, Farsi
فُرشاية،فَراشي،فُرشايات	brush
فَرشة	mattress, bed
فَرْشة،فَرْش	mattress
فُرصة،فُرَص	opportunity, chance, occasion, holiday, vacation (from study)
فَرض،فُروض	imposition, duty, homework
فَرع،فروع	branch, twig, area of study, learning track
فُرق	parting (of hair)
فَرق	difference
فَرق،فُروق	difference
فِرقة،فِرَق	company, team, troop, choir, band, troupe, division (military)
فَرك	rubbing, polishing, brushing
فَرمَشاني	pharmacist, chemist (the person)
فَرمَشِيّة	pharmacy, chemist (the shop)
فُرن،فرانة،فرونة،أَفران	stove, bakery
فرَنجي	european, western (in some expressions)
فرَنساوي	french
فرَنك	franc (currency)
فَريد	unique, incomparable, unrivalled, a common first name
فَريضة،فَرائَض	duty, religious obligation
فَريق،فِرَق	team
فَزّاعة	scarecrow
فَساد	corruption
فَسّاد	slanderer
فُستان،فُسطان،فَساتين،فَساطين	dress
فُسْتان،فَساتين	dress
فُسْتُق	peanuts
فُستُق،فُسدُق	general term for peanuts and pistachios
فَسحة،فَسَحة	space, gap
فُسفُساء،فُسَيفِساء	mosaic
فَسفوس	tiny, very small
فَشّة	lights (the lungs of a sheep, etc, when used as food)
فَشَل	failure
فِصح	Passover, Easter
فُصحى	classical, literary (Arabic)
فَصل	dismissal, expulsion, seperation
فَصل،فصول	season, chapter, act (of a play)
فَصولية	beans
فَصيح،فُصَحاء	fluent, eloquent, classical, literary (of Arabic), skilled in the correct use of FuSHa
فصيلة	bargaining
فَصيلة،فَصائَل	platoon, squad
فَضاوة	free time, leisure
فَضائي	space (adj), relating to outer space
فِضّة	silver
فَضل	favor, grace
فَضْل،أَفْضال	favor
فَضلة	remainder, remnant, leftovers, scraps
فَضى	void, space, daylight
فَضيحة،فَضايَح	disgrace, scandal, humiliation
فَضيلة،فَضايَل	virtue, good quality
فِطام	weaning
فُطر	mushrooms
فِطر	the feast that celebrates the end of Ramadan fasting
فطور	breakfast
فطيسة،فَطايَس	carcass, carrion
فَظاعة،فَظائَع	atrocity, horror
فَظيع	awful, dreadful, terrible, terrific, marvelous
فَعّال،فَعّالين	active, energetic, effective, efficacious
فَعّالِيّة	activity, effectiveness, efficacy
فِعل،أَفعال	action, verb
فِعلاً	really, actually
فَقاقي	liquid bubbles
فُقدان	loss (vn)
فَقَر،فَقر،فُقُر	poverty
فَقرة،فَقَرات	vertebra, paragraph, article, section, clause
فَقَط	only, just
فَقفولة،فَقافيل	blister
فِقه	Islamic jurisprudence
فَقّوسة،فَقّوس	a type of long thin cucumber
فَقير،فُقَراء	poor, in poverty
فَقير،فَقيرة،فُقَرا	poor
فُقَّيشة	christmas ornament, wooden or metal castanets (small cymbal used by dancers)
فَقيه،فُقَهاء	(muslim) jurist
فَكّ	jaw
فُكاهة	humor, joking
فِكر،أَفكار	thought, opinion, intention
فِكرة،أَفكار	thought, idea, notion
فِكْرة،إفْكار	idea, thought
فَكس،فاكس،فَكسات	fax
فَل	may.., let.., if only..
فُلّ	Arabian jasmine
فَلّاح،فَلّاحة،فَلّاحين،فَلّاحات	peasant, farmer
فَلّاح،فَلّاحة،فَلّاحين	farmer
فلاحة	ploughing, cultivating
فلاشَر	indicator (light), blinker, turn signal
فْلان	so-and-so
فلان عالْتَّلِفون،بِدّهُ يّاك	so and so's on the phone, he wants you
فلان،فُلان،فلانة	so-and-so
فلاني	such-and-such
فْلانِيّة	such-and-such
فِلتَر	filter (from English)
فَلسَفة	philosophy
فِلفَل	pepper
فلَفلة	small hot pepper
فَلَقة،فَلَقات،فُلَق	piece (of soap)
فَلَك	skies, heavens, celestial body
فلوس	money (technically a plural of فِلس, a small coin)
فلوكة،فلايَك	boat (Jerusalem, Egypt)
فَلّين	cork (coll.)
فَلّينة	a cork
فَنّ،فُنون	art, craft, technique, skill
فَنّان،فَنّانين	artist
فِنجان،فَناجين	cup
فِنْجان،فَناجين	cup
فُندُق،فَناديق	hotel
فَنَلّة،فَنَيلة	vest, undershirt
فَنّي	artistic, technical
فَهلاوي	quick-thinking, quick-witted, resourceful
فَوات	passing, lapse (of time)
فَوج،أَفواج	group, course, year (as in school year), intake, class (as in "class of '79")
فورمَن	foreman
فَوري	immediate, instantaneous
فَوضة	chaos, disorder, anarchy
فَوضَوي	anarchist, untidy person, slob
فَوضَوي،فَوضَويّة،فَوضَفويّين	anarchist
فَوضى	chaos, disorder, mess
فوطة،فُواط	napkin, serviette, small towel
فوق	up, upstairs, above, apart from, in addition, on top of
فوقاني	upper, top
فول	broad beans
فولة	one broad bean
فَيّ	shade
في	there is/are, in, at
فَيّ،فَيّات	shade
فِئة	group
فَيدوس،فَدوس	holiday (especially in rural Muslim speech)
فيزيا	physics
فَيَضان	flood
فَيل	index card (from english 'file')
فيل،فِيالة،فيول	elephant, bishop (chess)
فيل،فِيَلة	elephant
فَيلَسوف،فَلسِفاء	philosopher
فَين؟	where? (in some areas)
فيوز	fuse (from english)
ڤيديو	video
ڤَيرُس	virus
ڤيزا،ڤِيَز	viza
ڤيزا،يَعني كَرت إِعتِماد	viza, that's to say, a credit card
قاتَل	having killed
قادَر	able, can
قادِر،قادْرة،قادْرين	able
قادَم	next, coming
قارَض،قَوارَض	rodent
قاري	having read
قارَئ،قُرّاء	reader
قاسي	hard, difficult, harsh
قاصَر،قُصّار/قَواصَر	minor, under age
قاضي،قُضاء	judge
قاطَع	conclusive, decisive
قاع	bottom, (sea)floor
قاعة	hall, large room
قاعَد	sitting, OR this weird auxilary verb
قاعِد،قاعِدة،قاعِدين	sitting
قاعِدة،قَواعَد	base, principle, rule
قافية،قَوافي	rhyme
قالَب،قَوالَب	mould, matrix, pan, cake pan
قاموس،قَواميس	dictionary
قاهِرة،القاهِرة	Cairo
قائَد،قُوّاد/قادة	leader, commander, conductor
قايَم	standing, up (ie not in bed)
قائِمة،قَوائَم/قائِمات	list, table
قبال/إقبال	opposite, facing
قَبّان	platform scale, weighbridge
قَبّة	collar
قُبّة،قُبَب	dome
قَبر،قبور	grave, tomb
قُبرُص	Cyprus
قُبرُصي،قَبارصة	Cyproit
قَبَضاي	strong tough guy
قُبطان	captain
قُبطي،أَقباط	Copt, Coptic
قُبقاب،قَباقيب	pair of dogs
قَبْل	before
قَبلان	in agreement, in favor, accepting
قِبلة	the direction to which Muslims face at prayer (towards Mecca)
قَبو،أَقبِية	cellar, basement
قُبول	acceptance, admission
قتال	struggle, battle, brawl, fight, quarrel
قَتَل	killing, murder, beating, thrashing
قَتلة	a beating, a thrashing
قَتيل،قُتَلاء	murder victim
قَحّة	cough, coughing
قَحطة	scratch, scrape
قَد	maybe, perhaps, might, already
قَدّ	size, amount, quantity, extent, as much, as many, as little
قَدّاحة	cigarette lighter
قُدّاس،قَداديس	mass (religion)
قَداسة	holiness
قُدّام	in front of, ahead of
قُدّاماني	front (adj)
قَدَح،قداح	glass (for alcohol)
قُدُح،قدوح	hole (rural)
قَدَر	extent, size, proportion, rate, fate, divine decree
قُدرة	power, capacity, ability
قُدس،القُدس	Jerusalem
قُدسي،مَقادسة	Jerusalemite
قُدسِيّة	sanctity
قَدَم،أَقدام	foot, leg
قُدوة	example, model
قِدّيس	christian saint
قَديم،قُدَماء	ancient, old, senior, previous
قَرابة	(family) relationship
قَراض	ticks (parasites)
قِراط،قَراريط	carat (gold etc)
قُرآن،القُرآن الكَريم	the Qur'an
قِرائة	reading
قُرب	proximity, vicinity, closeness
قِربة،قِرَب	waterskin, hot water bottle, bagpipe
قَربيدة،قَرميد	tile (roof), brick(?)
قُرحة	ulcer
قِرد،قرود	monkey
قِرد،قْرُوْد	monkey
قِرش،قروش	piastre, cent
قُرص،قراص	round flat object, disc, disk
قَرصانة	piracy
قَرصة	pinch, sting, snake bite
قَرض،قُروض	loan, mortage
قَرعة	pumpkin, gourd, head, skull
قِرعة	lot, drawing/casting lots
قَرَف	nausea, physical disgust
قَرفان	nauseaed, disgusted, feeling sick
قِرفة	cinnamon
قَرَفس	celery (in some areas)
قُرقُزان	wagtail
قِرَقسة،قِرقَس	wagtail, moracilla (bird)
قُرقَعة،قَراقَع	tortoise, turtle
قِرمِيّة،قَرامي	tree stump, log, stub, counterfoil
قَرن،قُرون	century
قَرَن،قرون	horn, an elongated piece of fruit (resembling a horn)
قَرْن،قْرون	horn, century
قَرنَبيط	cauliflower (coll.)
قُرنة،قُرَن/قُراني	corner
قُرْنة،قَرَاني\قُرَن	corner
قَريب	near
قَريب،قَرايِب	relative
قَرْية،قُرى	village
قُرّيْص	nettles
قَزاز	glass, pane of glass
قَزَم،أَقزام	dwarf
قَزيز	frost
قَسط،أَقساط	installment
قَسطَر،قَساطَر	water main, (underground) water pipe
قِسَم،أَقسام	part, portion, section, department, ward
قِسمة	division (math), luck, fate
قِسَمتهُ	his fate
قِسوة	harshness, cruelty
قَسوة/قَساوة	cruelty, unkindness, harshness
قَسّيس،قُسُس/قَساسوة	clergyman (usually Protestant), minister
قَشّ	straw
قَشّارة	peeler
قشاط،قُشُط	belt, strap
قَشّة	straw, drinking straw, small piece of wood, matchstick
قِشرة،قشور	peel, peelings, crust
قِشطة	cream (especially thick cream), skin (on milk)
قَصّ	cutting, hairdressing
قَصّار/قَصّير	plasterer
قصارة	roughcoat, a smooth layer of concrete applied as a substrate to an interior wall prior to whitewashing or painting
قَصاص	punishment (usually within home/school)
قَصّاص	tracker, sniper?
قَصاص	punishment
قَصَب	cane, reeds
قَصَبة	a cane, reed, tube
قَصّة	haircut, hairstyle, cut (of garment etc)
قُصّة،قُصَص	story, tale
قُصّة،قُصَص	story
قَصد	intention, objective, purpose
قَصر،قُصور	castle, palace
قَصَف	bombing, shelling
قَصقوصة،قَصاقيص	scrap, small piece
قُصّيْب	reeds
قَصيدة،قَصائَد	poem
قَصير	short
قَصير،قَصيرة،قْصار	short
قضامة	roasted chickpeas eaten as a snack
قَضة	settlement, judgement, divine decree, fate
قَضيب،قُضبان	stick, bar, prison bar
قَضِيّة،قَضايا	matter, issue, problem, affair, business, case
قُطّ،قُطّة،قُطاط	cat
قِطار	train
قَطّارة	dropper
قطاع	sector, section, piece, strip (geo)
قَطايَف	small pancakes
قُطُب،أَقطاب	pole (geo)
قُطبة،قُطَب	stitch
قَطر	syrup (concentrated sugar solution)
قُطُر،أَقطار	diameter, diagonal, region, district
قِطْعة،قُطَع	slice, piece
قُطعة/قَطعة،قُطَع/قَطَع	piece, part, unit, plot (of land), coin
قَطَّعني،قَطَّع عَلَيّ	he interrupted me
قَطف	a harvest
قُطُف،قطوف	bunch (fruit)
قُطُن	cotton
قُطّيْن	dried figs
قَعَد جَمب واحَد عَم بوكُل خَنزير،تنَجَّس	he sat down next to someone eating pork so he became ritually impure
قَعدة	sitting, way of sitting, seat
قعود	sitting around (doing nothing)
قُفّة،قُفَف	basket (for carrying soil?)
قَفَص،قفاص	cage, playpen
قِفَل،قفولة	padlock
قَفى	back (of something), reverse (noun), wrong side, bottom, ass
قلادة	medalion, string, chain (series of objects)
قَلْب	heart, deep inside
قَلب،قلوب	heart, inside
قِلّة	lack, scarcity, shortage
قَلعة	castle / rook (chess)
قَلعة،قِلَع	castle, fort, fortress, citadel
قَلَق	worry, concern
قَلقان	worried, anxious, concerned
قَلْقان،قَلْقانة،قَلقانين	worried, disturbed
قَلَم،قلام/أَقلام	pen
قَلَم،أقْلام	pen
قَلّوسة،قَلاليس	cylindrical hat worn by priests of the Byzantine rite
قَلي	frying
قَليل،قلال	little, few
قَليل،قَليلة،قَلِيلِين	little
قمار	game(s) of chance, gambling
قماش،أَقمِشة/قمشات	fabric, material
قماط	nappies, diapers
قُمباز،قَمابيز/قُنباز،قَنابيز	a type of robe, open at the front, worn by old men
قُمبُلة،قَمابَل/قُنبُلة،قَنابَل	bomb, shell, grenade
قِمّة	summit
قَمَح	wheat
قَمحة	wheat kernel, grain of wheat
قَمحي	light brown (wheaty)
قَمَر	moon
قَمَر،قْمَار/أَقْمَار	moon
قَمَردين	sheet of pressed apricots
قَمَري	lunar
قُمُع	butt, stub
قَمَل	lice
قَملة	a louse
قَمّورة	sweetheart, sweetie pie, huneybunch, cutie (small moon, moonlet)
قَميص،قُمصان	shirt, blouse
قُنّ،قنان	henhouse, chicken coup
قَناة،قَناوات	canal, river bed, channel, TV channel
قِناع،أَقنِعة	mask
قَناعة	conviction, contentment, happiness with one's lot, frugality
قَنديل،قَناديل	oil lamp
قُنصُل،قَناصَل	consul
قُنصُلِيّة	consulate
قِنطَر	a unit of weight that varies from place to place
قُنفُد،قَنافَد	hedgehog
قَنوع	satisfied, content with one's lot, modest, frugal
قَنينة،قَناني	bottle
قَنّينة،قَناني	bottle
قَهر	sadness, misery, unhappiness, heartbreak
قَهْوة	coffee
قَوّار،قَواوير	plant pot, planter
قَوّاص	kawass (a ceremonial guardsman who marches in front of certain church dignitaries, thumping a stave rhythmically on the ground)
قواص/قواس	shots, shooting
قَوام	at once, straight away, immediately
قُوّة،قَوّات/قِوا	strength, force, power
قُوّة،قُوّات	strength
قوس قَزَح/قَدَح	rainbow
قوس،قَواس	bow (music, archery), quotation mark, bracket
قَومي	national, ethnic
قَومِيّة	nationalism, patriotism
قَويّ،قَوايا/أَقوِياء	strong
قَوي،قَوية،أقوِيا	strong
قِيادة	leadership, headquarters, command, HQ
قياس	measure, measurement, dimension, analogy, mat (Galilee)
قِياسي	record- (adj), standard (adj)
قِيام	rising, carrying out
قيامة	resurrection, uproar, tumult, row, riot
قيْح	pus
قَيصَر	Caesar, tsar, emperor
قيْصَري	imperial, caesarean
قيمة،قِيَم	value
كَآبة	dejection, depression, sadness
كابَل،كَوابَل	cable (from English)
كابوس،كَوابيس	nightmare, oppressiveness
كاتَب،كُتّاب	writing, having written, registrat, scribe, writer
كاتِب،كاكْبة،كاتبين	writer
كار	career, job, profession, trade
كارّة	cart, handcart, cart pulled by a donkey
كازَب	false, untruthful, deceptive
كاس/كأَس،كُؤُوس	cup, trophy
كاس/كاسة،كاسات	glass (for drinking)
كاس\كاسة،كاسات	cup, glass
كاسَد	unmarketable, unsold, on the shelf, unmarriagable
كاسَر،كَواسَر	predatory, savage
كاسيت	cassette
كافَر،كُفّار	unbeliever, infidel
كافي	sufficient, enough
كامْل	complete, full, perfect, whole
كامِل،كامْلة،كامْلين	complete
كامْن،كامنة	hidden
كان في	there was/were
كانون	charcoal-burning, stove,
كايَن	existing, located, situated, having been
كَبّارة	magnifying glass
كَبّاس	press stud, snap fastener, folding
كَبّاسة	stapler (in some areas)
كُبّاية	glass (like to drink)
كُبّة	hearts (suit in cards)
كَبت	repression
كَبتولة،كَباتيل	lump, chunk, ball
كِبد	liver
كِبدة	liver (food)
كَبَر	(old) age
كُبر	size, dimensions
كِبرِياء	pride
كِبريت	sulphur, matches
كَبسة	push, raid, sudden heavy shower (in some areas)
كَبسِيّة	raid, unexpected visit
كَبش،كبوش/كباش	ram (male sheep)
كُبكَبِيّة	ball of wool/yarn
كَبّود/كَبّوت،كَبَبيد/كَبَبيت	long coat, condom
كْبير،كْبيرة،كْبار	big
كَبيس	intercalary
كُتّاب	writer
كْتاب،كُتُب	book
كِتابة	insciption
كَتافة	density, crowdedness, congestion
كُتر	large quantity, abundance
كِتف،كتاف	shoulder
كُتلة،كُتَل	lump, chunk, mass, bloc, coalition
كَتّو	cake (French)
كَتوليك	catholic (usually Greek Catholics, ie Eastern Catholics)
كَتيبة،كَتائَب	batallion, brigade
كْتير،كْتيرة،كْتيرين	very, a lot
كَثيف	thick, dense
كَجَزاء	as a punishment
كُحل	kohl, eye ointment
كُحلي	navy blue
كُحول	alcohol, spirit
كديش	old horse, worn out horse, nag
كَذّاب،كَذابة،كَذّابين	liar
كِذِب	lie
كَذٰلَك	so, thus (educated speech)
كَراج	garage (from English)
كُرّاس،كَراريس	excersize book
كَراكيش	bits and pieces, junk, odds and ends, things
كَرامة	honor, respect, dignity
كُربَل،كُرابيل	coarse sieve (for stones, gravel, etc)
كُرة	ball
كَرت،كروتة	postcart, card (not a playing card)
كَرخانة	brothel
كُرِدور	corridor
كُردي،أَكراد	Kurdish
كرَديت	credit
كَرَز	cherries (coll)
كَرَّس،بيكَرَّس	do dedicate, consecrate, devote
كُرسي،كَراسي	chair
كَرش	belly
كَرَفس	celery
كَرم/كَرمة،كروم	vineyard, orchard
كرمال	for the sake of
كَرمَل	(mount) Carmel
كُره	hatred, loathing
كُرَيّة	small ball, blood cell
كريزة	emotional outburst, tantrum
كرَيك	spade
كريم	cream (cosmetic, icing, frosting, whatever)
كَريم،كُرَماء	generous, noble, distinguished, respected
كَريم،كَريمة،كِرام	noble, distinguised, respected
كَريمة	daughter (in high flown official language, like, "precious thing")
كَزا	such and such
كَزّاب	liar
كِزب	lies (coll)
كِزبة	a lie
كُزبَرة	coriander
كُسّ	cunt
كَسر،كسور	fraction, fold/pleat
كُسر،كسور	break, fracture
كَسلان	lazy
كَسْلان،كَسْلانة،كَسلانين	lazy
كَسم	form, shape, figure
كَشافة	scouting, recon
كُشان،كَواشين	certificate, deed
كِشتبان	thimble
كَشف	examination, disclosure, discovery
كَشفي	scouting, scout- (adj)
كَشفِيّة	consultation fee, examination fee (med)
كُشك	kiosk
كَعب/كَعَب،كعاب	heel (of foot, shoe)
كَعبة،الكَعبة	the Kaaba
كَعبولة،كَعابيل	ball (anything round)
كَعكة،كَعك،كَعكات	bagel, cake, bun
كَفّ،كفوف	palm of the hand, sole of the foot, glove, slap
كِفاح	struggle
كَفالة	guarantee, bail
كَفّاني	that was enough for me
كِفاي	enough
كَفائة	ability, capacity, skill
كَفّة	palm of the hand, sole of the foot, pan (on a set of scales)
كِفتة	kifte
كُفر	unbelief, blasphemy
كَفكير،كَفاكير	ladle
كَفَن،أَكفان	shroud, winding sheet
كَفِّيّة	keffiyeh
كَفيف	blind
كَفيل،كُفَلاء	guarantor, sponsor
كُلّ	all, every
كُلّ واحَد	everyone
كُلّ يوم	everyday
كلاتش	clutch (vehicle)
كَلام	words
كَلَب	rabies
كَلب،كلاب	dog
كَلْب،كْلاب	dog
كَلبة	bitch
كَلبَك،كَلابْك	fur hat
كِلس	lime(stone?)
كَلسة	stocking, sock
كَلسون،كَلسونات/كَلاسين	underpants (from french)
كَلَف	botches of pigmentation, liver spots
كُلفة	expenditure, outlay, costs
كِلْمة	word
كُلَّن	all
كِلوة	kidney
كلور	bleach, chlorine
كُلِّيّة	faculty
كليل	crown, Christian wedding ceremony
كُمّ،كمام	sleeve
كَم،قَدّيش	how much/many
كَم\أكَم	few
كَما	as
كَماً	also, as well, more
كماجة	flat round Arabic bread similar to pita
كَمّاشة	pincers
كَمالِيّات	luxuries
كَمّامة	muzzle, gas mask
كَمان	violin, fiddle
كَمان	also, again, too, more
كَمان مَرّة	again
كَمان واحَد	another one
كِماوي	chemical (adj)
كَمبيوتَر	computer
كَمَرةَ	camera
كَمشة	handful
كَمَنْجا،كَمَنْجات	violin, fiddle
كَمَنجةَ	violin, fiddle
كَمّون	cumin
كَمِّيّة	quantity
كَمين	ambush, trap
كُنادَر	pairs of shoes
كَنّاس	sweeper, street-sweeper
كنافة	a nice pastry
كَنَباية	armchair, couch
كِنّة	daughter in law
كُنترول،كُنترولِيّة	ticket inspector
كُنتَك	short circuit
كُندَرة	pair of shoes
كُنْدَرة،كَنادر	shoes (ladies)
كُندَرة/كُندَرجي	shoe / shoemaker, cobbler
كُندَرجي	shoemaker, cobbler
كُندَكتُر	conductor (orchestra)
كِنز،كنوز	treasure
كنيس،كنوس/كَنايَس	synagogue
كْنيس،كْنايِس	synagogue
كَنيسة،كَنائْس	church
كَهَرَباء	electricity, x-ray(?)
كَهرَبائي	electric, electrician
كَهَرَبجي	electrician
كَواليس	wings (in theater)
كوخ،كواخ	hut
كوربة	bend (road)
كوز،كواز	prickly pear (fruit of a pear cactus), small jug, small pitcher
كوسا	zucchini
كوساية/كوساي	one zucchini
كُوسة	zucchini
كوشة	mass, pile, swarm
كوع،كواع	elbow
كوفَلِيّة	diapers
كوم/كومة،كوام	heap, pile
كون	universe, being
كوَيَّس	good, beautiful, tasty
كيدون	handlebars (from French)
كيس،كياس	sack, bag
كيف	wish, pleasure, fun, hashish
كيف	how
كَيفِيّة	manner, mode, quality
كَيكس	cake
كَيل،كَيلة،كيال	measuring cup (no longer used in modern world)
كينا،شَجَرة الكينا	eucalyptus tree
كَئيب	gloomy, sad, depressed
لأ	no
لا بُدّ	it is imperative
لابِس،لابْسة،لابْسين	wearing
لاجَئ،لاجئين	refugee
لاحة	(facial) resmblance
لازِم	must
لازمة	refrain, chorus
لاسامي	anti-Semetic
لاسِلكي	wireless
لاشُعوري	the subconscious
لافِتة	placard, poster, sign, banner
لاكَن	but, yet, however
لِأنّو\لَإنّو	because
لاهوت	theology
لاوَعي	the unconscious
لائِحة،لَوائَح/لائِحات	list, table
لائِم	wicked, evil, bad
لَبّ	core, pulp
لِباس	clothes
لبان	chewing gum
لِبس	clothes
لِبق	nickname
لَبَن	curds
لَبَنة	a type of soft sourish creamy cheese yogurt thing
لَبيب	understanding, sensible
لَبَّيكَ	at your service!
لِتر	liter
لِثام	veil, mask (covering the lower part of the face)
لْثام،لْثامات	veil, mask
لجام	bridle, rein, reins
لَجَن،لجان،لَغَن،لُغُن،لغونة	large shallow bowl for laundry etc
لحاف،لُحُف	duvet, quilt
لَحال+ض	by my/your/him self
لحام	soldering, welding
لَحّام	butcher
لَحم،لحوم	meat, flesh
لَحمة	meat (cut and prepared for sale), piece of meat
لَحْمة،لُحوم	meat
لَحّوا عَليْي،رَضَخَت	they pressured me, I gave in
لِحية	beard
لَحّيم،لَحّيمة	solderer, welder
لَدى	at, in
لَزّة	pleasure, enjoyment
لَزقة	poultice, pest, pain in the neck
لَزَم	full, first, real, true
لَزيز	delicious, nice, pleasant, enjoyable
لُزَّيق	plaster, sticking plaster, band-aid
لِسّا	yet
لِسّا/بَعد	for لِسّا, Jerusalem, Jaffa, Gaza, Syria, and Egypt. For بَعد, Galilee and Lebanon
لِسّا+ض	still
لَصيقة،لَصائَق	sticker
لَطشة	slap
لُطف	kindness, niceness
لُطفاً	please
لَطيف،لَطيفة،لُطَفا	nice, kind, pleasant
لُعاب	saliva
لُعُب	play, playing, game
لُعْبة	game
لُعبة،لُعَب/أَلعاب	game, toy/doll,
لُغة،لُغات	language
لُغُز،أَلغاز	enigma, mystery, riddle
لُغُم،أَلغام	mine, landmine
لَفّ	(the action of) wrapping (up), turning, beating around the bush
لَفّة	roll, turban
لِفت	lift (from English)
لِفت،لِفتة	turnip
لَفتة	curve, bent (in road)
لَفحة	draft (wind), scarf
لَفظ	pronounciation, accent
لِقاء	meeting, encounter
لَقَب،أَلقاب	(official) title, nickname
لَقطة	opportunity, bargain, (lucky) find
لُقمة،لُقَم	mouthful, bite
لقِيّة	bargain, find
لَقيط،لُقَطاء	foundling
لَكان	so, then, if that's the case
لُكس	oil lamp
لِكَي	in order, so that
لَلْزَّينة	for decoration
لَمّا	when
لَمّا سِمَع هيْك،صَفَن	when he heard that he thought deeply
لَمبة	lamp
لَمْبة،لَمْبات	lamp
لَمّة	collection, collecting money (for charity etc)
لَمحة	glance, glimpse, peek, outline, overview
لَمعة	shine, brightness, glow, spasm, crick
لَمَّن	when (used instead of لَمّا in Galilee)
لَهجة	dialect, vernacular, tone (of voice)
لَهْجة،لَهْجات	dialect
لَو سَمَحت	excuse me
لِواء،أَلوِياء	flag, banner, brigade, brigadier (general), district, province
لِواط/لِواطة	homosexuality
لوبية	green bean
لوح قَزاز	a pane of glass
لوح،لواح/أَلواح	board, plank
لَوحة	board, picture, painting
لوز	almonds, tonsils
لوزة/حِبّةْ لوز	an almond
لوطي	homosexual
لَولا	if not for...
لولو	pearls
لوم	reproach, blame, rebuke
لَوَنّ	if
لون،ألْوان	color
لوئلوء	pearls
لَي	short for لّيش (why)
لَيانة	flexibility, suppleness
لِيّة	sheep's tail
ليستة	list
ليش	why
ليل	nighttime
ليلة،ليالي	night
لَيلَك	lilac
لَيلَكي	lilac (color)
لِيَّن	flexible
ليوان،لَواوين	entrance hall
مّا	Oh yes!
ما اْنقَتَل،ضَلّ طَيَّب	he wasn't killed, he's still alive
ما حَدا	no one
ما عاد،ما عَدْ،ما عَدْش	no longer, not anymore
ما عَدا	except
ما في	there is/are not
مُأَبَّد	eternal, everlasting
مَأخَد	grip, handle, fault, flaw, defect
ماخَد	having taken, married to
مُأَخَّر	postponed, delayed
مُأَخَّراً	lately
مُآخَزة	blame, censure
مُأَدَّب	polite, well brought up
مادّة،مَوادّ	material, substance, stuff, ingredient, article, clause
مُأَدَّن/مُأَذَّن	adan guy
مادّي	material (adj)
مار	Aramaic word meaning "sir", used by Christians for saints
مارِق،مارْقة،مارْقين	passing (act)
مارك	mark (old German currency)
ماركسي	marxist
مَأساة،مَآسي	tragedy, disaster, catastrophy
مَأساوي	tragic
مُأَسَّسة	organization, foundation, institution, establishment, association
ماسورة،مَواسير	pipe, main (for water etc), cylindrical bobbin, spool
ماشطة	hairdresser
ماشي،ماشية،ماشيين	walking
ماضي	past, sharp/sharpened
ماكَل	having eaten
ماكِنا،ماكِنات	machine
ماكَنة	machine
مَأكول	eaten
مال،أَموال	money, property, posessions
مال،أمْوال	wealth
مالتي	Maltese
مالَج	float (a hand tool with a rectangular blade used for smoothing cement
مالَح	salty
مالَس	smooth, straight
مالطا	Malta
مُأَلَّف	author, writer
مالِكي	malikite
مأَلَّم	blunt, dull
مالي	material, financial
مُآمَرة	conspiracy, plot
مُأَنَّث	feminine
مانَع،مانعة	obstacle, impediment, reason why not, objection, opposition, person who doesn't allow / has forbidden
ماهَر	skillful, skilled, expert
مُأَهِّلات	skills, abilities
مَأوى،مَآوي	shelter, refuge
مايَع	liquid (adj), fluid, melting
مايَل	leaning
مُبادَرة	initiative
مُباراة،مُبارايات	competition, match
مْبارِح	yesterday
مُباشَر	direct
مُبالاة	consideration, concern, attention, heed
مُبالَغة	exaggeration
مَبحوح	hoarse
مَبخَرة،مَباخَر	censer
مَبدَئ،مَبآدَئ	principle, beginning, basis
مَبرَد،مَبارَد	file (tool)
مُبَرَّر	justification, excuse
مَبرَشة	rasp, grater
مَبرور	dutifuly performed, accepted in to the grace of god
مَبروك	blessed
مَبرومة،مَباريم	bracelet, metal bangle (spiral)
مبَزَّر	frosted (glass)
مَبسوس	dough made of flower and butter
مَبْسوط،مَبْسوطة،مَبْسوطين	pleased
مُبَشَّر	(christian) missionary
مَبشَرة	grater
مُبعَد	banished, exiled, excluded (distance)
مُبْعَد،مُبْعَد،مُبْعَدين	deportee, banished, excluded, exiled
مبَقبَش	blistered, covered in blisters
مُبَكَّر	(too) early
مبَلا	yes (used to contradict negatives)
مَبلَغ،مَبالَغ	sum (of money)
مَبْلَغ،مَبَالِغ	amount
مَبلوش	busy, immersed (in work), right in the middle (of a task)
مَبلول	wet
مَبْني،مَبْنيّة،مَبْنيين	built
مبو	a drinkie
مُبيد	destroyer, destroying, exterminator, exterminating
مَبيض	ovary
مِبيَّضة	fair copy (of a document)
مَبيع،مَبيعات	sales
مْبيِّن	apparently
مِتأَخَّر	late
مِتأَخِّر،مِتأَخّْرِة،مِتأَخّْرِين	late
مِتأَسَّف	sorry
مِتْأسِّف،مِتْأسِّفة،مِتْأسِّفين	feeling apologetic
مِتأَكَّد	sure, convinced
مَتال	example, proverb
مَتانة	bladder
مُتَبادَل	mutual, reciprocal, reciprocated
مِتبَرَّع	volunteer
مُتَّبَع	customary, usual, current, generally accepted
مِتبَنّى	adopted
مِتبَنّي	adoptive, adopting
مِتجَوِّز،مِتجَوِّزة	married
مِتجَوَّل	itinerant, travelling, wandering, mobile
مُتحاصمين	the disputants, the combatants, those involved in the conflict
مُتَحَجَّر	fossilized
مِتحَفَّظ/مُتَحَفَّظ	wary / cautious
مِتحَمَّس	enthusiastic
مِتحَمَّس	enthusiastic
مِتحَيَّر	confused, embarrassed
مِتحَيَّز	prejudiced, biased, partial, taking sides
مِتخَبّي	hidden
متَختَخ	ramshackle, falling apart, ragged, in rags
مُتَخَرِّجين	graduates
مُتَخَلَّف	backward, retarded, lagging behind
مُتَدَيَّن	religious, devout, observant
مِتر،مَتورة/أَمتار	meter
مُتَرادَف	synonym(s), synonymous
مِتراس،مَتاريس	barricade
مِترَبَّع	sitting cross legged
متَرجَم	translated
مِترَدَّد	hesitating
مَتروك	left (to)
مَتْروك،مَتْروكة،مَتْروكين	abandoned
مُتَّزَن	balanced, reasonable, sensible
مِتساوي	equal
مِتسَمَّم	poisoned (victim of poisoning)
مِتسودَن،مِتسودنة	sulking, sulky
مِتشابَه	similar, looking alike
مِتشائَم	pessimistic, pessimist
مِتشَكَّر	thankful
مِتصَنَّع	affected, phony
مُتَضَخَّم	inflated, distended
مُتَطَرَّف	extreme, extremist, radical
مُتَطَوَّع	volunteer
مُتَظاهَر	demonstrator
مُتعة	enjoyment, delight, pleasure, satisfaction
مِتعَصَّب	extremist, fanatic
مِتعَطَّش	thirsting for, longing for
مِتعَطَّل	unemployed
مُتَعَهَّد	contractor, one who commits/obligates themself
مِتعَوَّد	used to, accustomed to
مِتغَدّي	having had lunch, already had lunch
مِتفآئَل	optimistic, optimist
مُتَفَجَّر	explosive
مِتفَوَّق	excellent, outstanding, first-rate
مِتقاعَد	pensioner, retired
مُتَقَدَّم	advanced
مِتقَشَّف/مُتَقَشَّف	ascetic
مُتَقَطَّع	intermittent, alternating (current)
مِتقَلَّب	changeable, capricious, fickle, unpredictable
مُتقَن	exact, precise
مِتكَتَّف	with arms folded
مُتَّكَل	relying, dependent
مُتَكَلَّم	speaking, speaker
مِتَّكي	leaning
مِتْل	like, similar to, as
مَتلًا	for example
مِتمَدَّد	lying down stretched out
مُتمَسَّك	clinging to, sticking to
مُتَنازَع	rival, contestant, litigant party
مُتَناقُض	contradictory, incompatible
مَتنِي	folded
مُتَّهَم	accused
مِتهَيَّج	in a state of ferment, revolting, stormy
مِتوازَن	balanced
مِتوازي	parallel
مِتواضَع	humble, modest
مِتوَتَّر	tense, on edge, strained
مِتوَقَّع	expecting
مِثال،مُثُل	example, model, ideal
مِثالي	ideal, model, exemplary
مُثَقَّف	intellectual
مُثَلَّث/مُتَلَّت	triangle
مُثَنّى،المُثَنّى	dual (grammar)
مَجاز	metaphor
مَجال	space, room, field, domain, area, scope, opportunity
مُجامَلة	(good) manners, courtesy, convention, social usage, formalities, niceties
مَجّاناً	for free
مَجّاني	free of charge
مُجاوَر	neighbouring
مجَبَّر	osteopath, bone-setter
مجَبصَن	plastered, in plaster
مَجبور	obliged, compelled, forced, have to
مَجْبور،مَجْبورة،مَجْبورين	forced
مُجتَرّ	ruminant (?)
مُجتَهَد/مِجتهَد	hard-working
مِجداف،مَجاديف	oar
مجَدَّر	having smallpox, someone with smallpox
مجَدَّرة	delicious lentil and rice dish. very cheap to make. look it up.
مجَدَّل،مجَدّلة	plaited, braided (hair)
مَجَر،المَجَر	Hungary
مَجرا	draft
مجَرَّب	experienced
مُجَرَّد	naked, denuded, plain and unadorned, abstract, just
مُجرَم	criminal, culprit
مَجروح،مَجروحة،مَجَارِيْح	wounded
مَجرود،مَجاريد	dustpan
مَجرى،مَجاري	stream, sewer, current, course
مَجزَرة،مَجازَر	massacre
مجَعَّد	wrinkled, lined, curly
مجَعلَك	creased, crumpled
مجَفَّف	dried
مَجَلّة	magazine, periodical
مجَلَّد	(leather) bookbinder
مُجَلَّد	volume (archive, book)
مَجلى،مَجالي	sink
مَجْلى،مَجَالي	kitchen sink
مَجلي	washed, polished
مجَمَّد	frozen, stiff, congealed
مجَمرَك	cleared through customs
مَجمَع،مَجامَع	meeting, assembly, synod
مَجموع،مَجاميع	total, whole
مَجموعة	collection, compilation, group
مُجَنَّد	recruited, enlisted, mobilized
مجَنزَر	covered in sediment/verdegris
مجَنزَر	tracked vehicle (like a tank)
مَجنون/بَهلول/وَزير	bishop (chess)
مَجهَر،مَجاهَر	microscope
مجَهَّز	ready, having prepared
مَجهود	effort
مَجهول	unknown, anonymous
مِجوَز	even, double
مُحادَثة	conversation
مُحاسَب	accountant
مُحاسَبة	accountancy, accounting
مُحاضَر	lecturer
مُحاضَرة	lecture, talk
مُحافَظ	conservative, traditional
مُحافَظة	preservation, conservation
مُحاكَمة	trial
مُحاماة	law, the legal profession
مُحامي،مُحاميّة،مُحامين	lawyer, advocate, counsel
مُحاوَلة	attempt
مَحّاية	rubber, eraser
مُحايَد	neutral
مُحايَدة	neutrality
مَحَبّة	love, affection
مَحبَس،محابَس	wedding ring
مُحبَط	frustrating
مَحبوب	loved, beloved, liked
مَحبوب،مَحْبوبة،مَحبوبين	beloved
مَحبوس	locked up
مَحبوس،مَحابيس	imprisoned, shut up, prisoner
مِحتاج	needing, requiring
مُحتَرَف	professional
مُحتَرَم	respected, esteem, respectable
مُحتَشَم	modest, decorous
مُحتَلّ	occupying, occupied
مُحْتَلّ،مُتَلّة،مُحتَلّين	occupied
مُحتَلّين	occupiers
مُحتَوى	content (s)
محَجَّب	veiled
مَحدَدة	forge, blacksmith's workshop, smithy
مَحدود	limited, bounded, confined, fixed
مَحرات،مَحاريت	plow
محَرَدب	hunchbacked
مُحَرَّر	editor, liberator
مَحرَمة،مَحارَم	handkerchief
مَحروس	guarded, protected
مَحروق	burned
مَحروم	deprived, dispossessed
مُحسَن	philanthropist, benefactor, donor
مَحسوب،مَحاسيب	protogé, person in someone's service
مَحسوبِيّة	favoritism
مَحسوس	felt, perceptible
مَحْسوس،مَحْسوسة،مَحْسوسين	felt
مَحسوم،مَحاسيم	roadblock, checkpoint (from Hebrew)
مَحشَشة	hashish den
مَحشورين	squashed together
مَحشي	stuffed
مَحصول،مَحاصيل	harvest, produce
مَحَطّة	station (bus railway etc)
مَحَطّة،مَحَطّات	station
مَحْطوط،مَحْطوطة،مَحْطوطين	put, placed
مَحظوظ	lucky
مَحْظوظ،مَحْظوظة،مَحْظوظين	lucky
مَحفَظة	wallet
مَحفور	dug
مَحفوظ	kept, retained, memorized
مُحقان،مُحاقين	funnel
مُحَقَّق	investigator, interrogator
مَحقَن،مَحاقَن	funnel (for pouring liquids)
مَحكَمة،مَحاكَم	court
مَحل	drought
مَحَلّ،مَحَلَّات	room (space), place, shop, store
مُحَلَّف	juror, member of the jury
مَحلَقة	barber shop
مَحمَص،مَحامَص	coffee roaster's, coffee roasting company
مَحمَصة	roaster, toaster
مَحمول	bearable, tolerable
مَحمي	protected
مَحمِيّة	reserve
مُحَنَّط	embalmed, stuffed
مِحوار،مَحاوَر	axis, plot, center
محَيَّر	confusing, puzzling, embarrassing
مُحيط	ocean, surroundings
مُخّ	mind, brain
مَخاضة	ford, crossing place (river)
مُخاطَب	addressed, spoken to
مخاطة	snot, nasal mucus
مُخالَطة	mixing, mingling, contact
مُخالَف	offender
مُخالَفة	contravention (of the law), infringement, offense, breach (of the peace), ticket (for a small offense)
مخاوَزة	favoritism
مَخاوَف	fears, anxiety
مخَبّة/مخَبّاية	hidden
مُخبَر	informant, snitch
مَخبَز،مَخابَز	bakery
مَخبوز	baked
مَخبى،مَخابي	hiding place
مْخَبّي،مْخَبّية،مْخَبّيين	hiding (act)
مُختال	arrogant, concited
مُختَبَر	laboratory
مُختَرَع	inventor
مُختَصّ	competent, specialised
مُختَطَف	kidnapper, hijacker
مُختَلّ	disturbed, unbalanced, out of order
مُختَلَط	mixed
مِختَلَف	differing, different
مخَدّة	pillow
مَخدوش	scratched
مُخَرَّب	terrorist, destroyer, sabotager, vandal(?)
مخَربَط	confused, muddled
مَخرَج،مَخارَج	way out, escape
مَخرَز،مَخارَز	awl, punch
مَخرَطة،مَخارَط	lathe
مخَزَّق	holed, with several holes
مَخزَن،مَخازَن	storeroom, warehouse
مَخْزَن،مَخازِن	storeroom
مَخزوق	holed, has a hole in it
مخَشخَش	soft in the head, not all there
مخَصَّص	special, kept specially for (a particular purpose)
مُخَصَّص	allowance, (state) benefit
مَخصوص	special, especially, specially
مَخْصوص،مَخْصوصة،مَخْصوصين	special
مَخصي	castrated
مُخطَر	dangerous
مُخّطَّط	planned, scheduled
مَخطوط	handwritten
مَخفَر	police station
مَخلَب،مَخالَب	claw, talon
مخَلخَل	unsteady, shaky, wobbly
مخَلَّص	finished, having finished
مُخلَص	faithful, loyal, dedicated, devoted
مخَلَّل	fermented, pickled
مَخلوط	mixed, mixture
مَخْلوط،مَخْلوطة	mixed
مَخلوق	created, creature
مخَمَّج	overripe, on the point of rotting
مْخَمِّج،مْخَمْجِة	rotten, overripe
مخَمَّن	assessor / appraiser
مخَنَّط	effeminate, homosexual
مَخنوق	strangled, suffocated, choked, muffled, stifled
مُخيف	frightening
مُخَيَّم	camp
مُدار	administered
مُداعي	prosecutor
مَدبَحة،مَدابَح	massacre
مَدبَرة	swarm (of bees), beehive
مُدّة	period of time, a while
مُدّة،مُدّات	time period
مَدح	praise, compliments
مَدحَلة،مَداحَل	steamroller, road-roller
مَدخَل،مَداخَل	entrance
مَدخَنة،مَداخَن	chimney, funnel
مَدخول	income
مُدَرَّب	trainer
مُدَرَّج	graded, graduated, auditorium, ampitheater, stadium
مَدرَسة،مَدارِس	school
مَدفَع،مَدافَع	cannon
مَدَقّة	pestle (for grinding things)
مْدَلَّع	spoiled
مِدماك،مَدَميك	a course of bricks
مُدمَن	addicted
مَدمون	assured, guaranteed
مَدمون،مَدامين	contents, content
مُدهَش	astonishing, amazing
مِدهَن	fatty (of food)
مَدْهون،مَدْهونة،مَدْهونين	painted
مدَوَّد	worm-eaten
مدَوَّر	round
مْدَوزَن،مْدَوزْنة،مْدَوزْنين	tuned (musical instrument)
مَدى	distance, extent, range
مُدير،مُديرة،مُدَرَا	supervisor
مُدير،مُديرة،مُديرين	manager, director, principal
مَدينة،مُدُن	town, city
مَديون	in (someone's) debt, owing, indebted
مُذيع/مُزيع	announcer, newsreader
مُرّ	bitter
مَرأَ	sight, a sight
مَرّات	sometimes
مُراجَعة	review, revision, audit, rehearsal, petition, application, petition, application
مَراحيض	public toilets
مُرادَف	synonym, synonyms
مَرارة	gall, bile
مُراسَل	correspondent, reporter, messenger
مُراسَلة	correspondence
مُراعَضة	opposition, objection
مُرافَقة	accompaniment, escort
مراقَب	supervised, monitored, checked up on, censored
مْراقَب،مْراقْبة،مْراقْبين	censored, controlled, supervised
مُراقَبة	observation, supervision, censorship, control
مُراهَق	teenager, adolescent
مْراي\مْراية،مُري\مَرايا	mirror
مُربَح	profitable, lucrative
مرَبرَب	huge, enormous, fat
مرَبَّط	thoroughly tied up
مرَبَّع	square (adj)
مَربوط	tied up
مَرْبوط،مَربوطِة،مَربوطين	tied
مرَبّى،مرَبّايات	jam
مُرَبّي	breeder (of livestock), educator
مْرَبّي،مْرَبّية،مْرَبّيين	having brought up, educator, breeder, well brought up
مَرّة	once
مَرّة،مَرّات	instance
مَرَة،نِسوان\نِسا	woman
مُرتاح	relaxed, at rest, calm, relieved, reassured
مَرتَبة،مَراتَب	grade, rank, place
مِرتجَف	shaky, trembling, stuttering
مُرتَجَل	improvised
مُرتَدّ	apostate
مُرتَفَع	high, elevated
مَرَتين	twice
مَرجَع،مَراجَع	source, authority, reference book, competent authority
مَرْجِع،مَراجِع	resource, official application authority, office of appeal
مُرجَيحة،مَراجيح	swing
مَرْحَبا	hello
مَردود	output, yield, return(s), income
مَردود	given back, sent back
مِرساه/مِرساية،مِراسي	anchor
مرَستَق	elegant
مَرسوم	drawn
مرَشّ	watering can, sprayer, spray gun
مرَشَّح	having a cold
مُرَشَّح	candidate
مْرَشِّح،مْرَشِّحة،مْرَشِّحين	having a cold, having a runny nose
مُرشَد	guide
مَرضوض	bruised
مُرضي	satisfying, satisfactory
مَرطَبان	jar
مُرعَب	frightening, alarming, terrifying
مَرعى،مَراعي	pasture
مَرغوب	wanted, desirable, sought after, in demand
مَرفوض	undesirable, unacceptable, unsatisfactory, objectionable
مِرَق،مِرقة	thin, watery
مَرَقة	chicken soup, gravy
مرَقَّط	spotted
مرَقَّم	numbered
مُرَكَّب	complicated, complex, hang-up
مَرمِي	thrown
مَرْمي،مَرْميّة،مَرْمِيين	thrown
مَرَن	supple, flexible
مَرهَم،مَراهَم	ointment, cream
مَرهون	pawned, mortaged
مرُوّة	energy, vitality
مرَوَّح	gone home, left
مَروَحى،مَراوَح	fan, ventilator, propeller
مَروَحِيّة	helicopter
مُرور	passing, passage, access
مرَوَّس	sharpened
مُرَوَّض	(animal) trainer, breaker
مُرونة	flexibility
مَروني،مَوارنة	Maronite
مُريح	convenient, comfortable, easy, user friendly, restful
مَرّيخ،المَرّيخ	Mars
مَريض،مَريضة،مَرضَا	sick, patient
مَريَم	Mary
مَريَمِيّة	sage (vegetable)
مُرَينا،مَرايَن	beam, rafter
مَريول،مَراييل	apron
مِزاج	mood, temperament
مِزاجي	temperamental
مِزاجِيّة	temperamentalness
مَزاد	auction
مُزارَع	farmer
مُزايكا/مُزايكو	mosaic
مَزبَلة،مَزابَل	garbage heap, dump
مَزّة/مازا	mezze, snacks
مَزح	joking, laughter
مزَخرَف	decorated, ornamented
مُزدَهَر	thriving, prosperous, flourishing
مِزراب،مَزاريب	gutter (on roof), drainpipe
مَزرَعة،مَزارَع	farm
مزَفَّت	tarred, surfaced, paved
مُزَكَّر	masculine (grammar)
مُزمَن	chronic
مَزمور،مَزامير	psalm
مُزنَب/مُذنَب	guilty, culprit
مَزنوق	pressed, compressed, under pressure
مزَوَّر	forged, fake
مِزوَق	possessing good taste
مَزيج	mixture, blend, combination
مزَيَّف	counterfeit, forged
مَسا الخير	Good evening
مَسا النور	Good evening
مُسابَقة	competition, quiz
مَساج	massage
مَسّاح	surveyor (land)
مَساحة	area, extent
مَسّاحة	windscreen wiper
مُساعَد	deputy, assistant
مُساعَدة	help, assistance
مَسافة	distance
مْسافَر،مْسافْرة،مْسافْرين	having travelled
مُساهَمة	contribution
مُساواة	equality
مُسايَرة	willingness to please, consideration, amenability
مَسائي	evening (adj)
مسَبّة	swear word, curse
مَسبَحة،مَسابَح	string of beads, rosary, prayer beads, worry beads
مُسبَق	preceeding
مَسبوك	a cast (something that's been cast, like, metal)
مُستأَجَر	rented
مِستأَجَر	renter, tenant
مِستاهَل	deserving, worthwhile
مُستَبعَد	improbable, unlikely
مُستَدير	round
مسَتَّر/مسَتّرة	covered (in clothes etc)
مُستَشار	advisor, consultant
مُستَشرَق	orientalist
مُستَطيل	rectangle, rectangular
مُستَعار	borrowed
مِستَعجَل	urgent
مِستَعجِل	hurried, in a hurry
مِستعَدّ/مُستَعَدّ	prepared, ready, willing
مُستَعمَرة	colony
مُستَعمَل	used, second-hand
مِستعير	having borrowed (AP)
مُسْتَقْبَل	future
مُستَقَرّ	stable, sedentary
مُستَقيم	straight, honest, upright, trustworthy
مِستكة،مِسكة	gum
مُستَمَرّ	perpetual, lasting, continuing, constant, eternal
مُستَمَرّ	constant, continuous, steady, permanent
مُستَمَع	listener
مُستَنَدّ	document
مُستَنقَع	swamp
مِستَنّي	waiting (as in "I am waiting")
مَستور	protected (by God, from disgrace/slander/etc)
مَستور	respectable, of good reputation (esp women/girls)
مُستَورَد	imported
مُستَوصَف	clinic
مُستَوضّع	warehouse, depot, storehouse
مُستَوطَن	settler, colonist
مُستَوطَنة	settlement, colony
مُسْتَوَى،مُستَوَيَات	level
مِستوي	ripe, cooked, done, exhausted, worn out, done in
مَسجِد،مَساجَد	mosque
مسَجَّل	(tape) recorder, cash register
مسَجَّل	registered
مَسحور	enchanted
مَسخَرة،مَساخَر	laughing stock, object of ridicule, fancy dress, masquerade
مَسدود	blocked
مُسَرَّح	demobilized, demobbed (soldiers etc)
مسَرسَب	obsessed
مَسرور	happy, pleased, glad
مَسروق	stolen
مسَطَّر	ruled, lined
مَسطَرة،مَساطَر	ruler (for drawing lines)
مسَطَّل	disorientated, spaced out, woozy, distracted
مَسطول	drunk, drugged, high, stoned
مسَفلَس	syphilitic, having syphilis
مسَقَّع	very cold
مسَكَّر	closed, locked
مَسكَن،مَساكَن	home, place of residence
مُسَكِّنات	tranquillisers
مَسكون	inhabited, populated
مِسكين	poor, unfortunate
مِسكين،مِسكينة،مَساكِيْن	poor
مُسَلَّح	armed
مَسلَك،مَسالَك	way, (traffic) lane
مَسلوق	boiled
مُسَمّ	poisonous, venomous
مُسمار،مَسامير	nail (carpentry)
مَسمَكة،مَسامَك	fish shop
مَسموح	permitted, allowed
مَسْموح،مَسْموحة،مَسْموحين	allowed
مَسموم	poisoned, poisonous
مسَنّ	grindstone, whetstone (handheld)
مُسَنّ	old, elderly, old person
مُسهَل	laxative
مَسهول	suffering from diarrhoea
مِسوَدّة	draft, negative (photos)
مسَوَّس	worm-eaten, decayed
مَسْؤل،مَسْؤلة،مَسْؤلين	questioned
مَسْؤليّة	responsibility
مَسوني	freemason
مسَيَّج	fenced off, fenced in
مُسيل	causing to flow
مُشاغَبة	trouble, disturbance
مشافتَر	thick lipped
مُشاهَد	onlooker, viewer
مُشاهِدين	viewers (tv etc)
مَشايَخ	elders, notables
مَشبَك،مَشابَك	clip
مَشبوه	suspect, suspicious
مَشْبوه،مَشبوهة،مَشْبوهين	suspicious, suspect
مِشتاق	missing someone
مُشتَرة	bought (not homemade)
مُشتَرَك	common, shared
مِشترَك/مُشتَرَك	participant, subscriber
مِشتري/مُشتَري	buyer, purchaser
مَشتَل/مَشاتَل	nursery (for plants)
مُشَجَّع	encouraging
مِشحاف	stripping knife (for removing paint etc)
مشَحبَر	burnt black
مشَرَّب	drenched, soaked
مشَربَك	tangled
مُشَرَّدين	exiles, refugees
مشَرَّش	covered in varicose veins
مشَرشَح	worn out, treated badly, humiliated, abused
مُشَرَّع	legislator
مُشرَف	supervisor, invigilator
مُشرَك	polytheist
مَشروب	drink, beverage (mainly alcoholic)
مَشْروب،مَشْروبة،مَشْروبات	drink
مَشروط	conditional
مُشط،مشاط	comb, magazine (of weapon), that christian fish
مَشعَل،مَشاعَل	torch, flare
مَشعور	cracked, split
مُشَغَّل	employer
مَشغَل،مَشاغَل	factory, workshop, sewing workshop
مَشْغول،مَشْغولة،مَشْغولين	busy
مَشقوق	cracked, split open
مَشقوق	slightly open, ajar
مشَكَّل	assorted, various, vocalized, vowelized
مُشكِلة/مُشكِلتجي	problem / troublemaker
مشَلَّط	reckless, heedless
مَشلول	paralyzed
مشَمَّس	sunny
مشَمَّع	waterproofed, oilcloth, oilskin, raincoat
مشَنَّج	ricked, sprained, in spasm
مشَنَّص	lucky
مِشوار،مَشاوير	excursion, walk, errand
مُشْوار،مَشاوير	excursion, errand
مشَوَّب	(feeling too) hot
مشَوَّش	confused, muddled, confusing?, middling?
مشَوَّق	arousing desire / eagerness, interesting
مشَوَّه	misshapen, deformed, disfigured
مَشؤوم	unlucky, ominous
مَشوي	roasted, grilled
مَشية	walk, way of walking
مشَيَّد	well-built
مُصاب	injured, hurt, casualty, afflicted, infected
مُصادَرة	exportation, confiscation, export, impounding
مُصادَقة	(official) approval, ratification
مَصاري	money
مَصّاصة	lollipop, pacifier
مصَبَّر	stuffed (taxidermy)
مَصبَغة،مَصابَغ	laundry, laundrette, laundromat
مَصبوغ	dyed
مُصتَنَع	forced, artificial
مَصَحّ	convalescent home, sanatorium
مُصحَف،مَصاحَف	copy of the Qur'aan
مَصحوق،مَصاحيق	powder
مصَدّي	rusty
مُصَرّ	determined, resolved, sticking to
مُصران،مَصارين	intestine, bowel
مَصروف،مَصاريف	expense
مَصْروف،مَصاريف	expense
مُصطَلَح	conventional, customary, linguistic term
مَصعور	rabid, infected with rabies
مُصَغَّر	reduced, smaller
مصَفّاي	filtered
مَصفاية،مَصافي/مَصفايات	filter, strainer
مصَفَّح	armored
مَصل	serum
مَصْلَحة	interest, benefit
مَصلَحة،مَصالَح	interest, benefit
مَصلوب	crucified
مُصَمَّم	determined, resolved
مُصَمَّم	designer, planner
مَصنَع،مَصانَع	factory
مصَوَّر	photographed, illustrated
مصَوَّر	photographer
مصيبة،مصايَب	misfortune, trouble, disaster
مَصيَدة،مَصايَد	trap
مَصير	fate, destiny
مَصّيص،خَيط مَصّيص	string, twine
مصَيَّف	wearing summer clothes, spending summer
مُضاد	opposed, contrary, anti-
مُضارَب	speculator, competitor
مُضارَبة	speculation (stock exchange etc)
مُضاعَفات	complications, side effects
مُضحَك	funny, amusing, ridiculous, laughable
مضَخّة	pump
مُضّرّ	harmful, noxious
مُضرَب	striker
مَضرَب،مَضارَب	camp, campsite, encampment
مُضطَهَد	persecuted
مَضغوط	pressed, compressed
مَضْوي،مَضْويّة،مَضْوِيين	lit
مَطار،مطارات	airport, airfield
مُطارَد	wanted, pursued, hunted down, stalked
مُطارَدة	pursuit, chase, harassment
مَطّاط	elastic, stretchy, rubber (adj)
مَطّاطي	rubber (adj)
مُطالَعة	reading (for study or pleasure)
مَطاهَر	bathrooms, washrooms (especially next to mosques)
مَطْبَخ،مَطابِخ	kitchen
مَطْبَع	printing house
مَطبَعة،مَطابَع	printing house, print shop, printer's
مَطبوخ	cooked
مَطْبوع،مَطْبوعة،مَطْبوعين	printed
مَطحَنة،مَطاحَن	grinder, mill
مَطْحَنة،مَطاحِن	grinder
مَطَر،أَمطار	rain
مُطران،مَطارنة	archbishop (also used to address a normal bishop)
مُطْرِب،مُطرِبة،مُطرِبين	singer
مَطَرة	water canteen, water bottle
مَطرَح،مَطارَح	place, spot
مطَرَّز	embroidered
مِطرَقة	hammer
مطَعَّم	vaccinated
مَطعوج	bent, dented
مَطفي	extinguished, switched off, turned off
مَطلَب،مَطالَب	request, demand
مَطلَع	beginning, stairwell
مُطَلَّع	apprised, updated
مطَلَّق	divorced
مُطلَق	absolute, total
مَطْلوب،مَطْلوبة،مَطلوبين	requested
مَطلي	coated
مطَهَّر	circumsized
مطَوَّق	surrounded
مَطوي	folded
مُطيع	obedient
مُظاهَرة	protest, demonstration
مَظْبوط	all right
مظَلبَط	naked, nude
مِظَلّة	parachute
مظَلَّط	nude, naked
مَظلوم	oppressed, unjustly treated
مَظهَر،مَظاهَر	appearance, sight
مَع	with
مَع السَلامة	bye
مَع بَعض	together
مَع بَعْض،سَوا	together
مُعادَلة	equation
مُعارَضة	opposition
مَعاش	salary, allowance, pension, benefit
مَعاش،مَعَاشَات	salary
مَعّاصة	mill, grinder, masher, crusher
مُعاصَر	modern, contemporary
مُعاكَس	opposing, opposite, contradictory, counter
مُعالَجة	treatment, treating, taking care
مْعامَلة	treatment, attitude, behavior
مُعاوَن	deputy, assistant
مُعاوَنة	help, assistance, support
مَعبَر،مَعابَر	crossing point (as in Rafah), pass, defile, ford
معَبَّق	strong scented, smelly
مُعتَدَل	moderate, temperate, mild
مُعتَقَد	creed, belief (believed)
مُعتَقَل	under arrest, arrested, detained, held
مُعجَب	admirer, fan
مُعجِزة	miracle
مَعجونة،مَعاجين	paste, cream (cosmetic), putty, filler, plasticine, modelling clay
مُعَدّات	appliances, equipment, gear
مِعدة	stomach
مَعدَن،مَعادَن	metal
مُعدي	infectious, contagious
مَعرَج	Mohammed's ascension to heaven
مَعرَض،مَعارَض	exhibition
مَعرِفة،مَعارَف	knowledge, information, acquaintance, friend
مَعرَكة،مَعارَك	battle, campaign
مَعروف	known, well known, familiar, favor, good deed, charity
مَعْروف،مَعْروفة،مَعْروفين	kindness
مَعزا	goats (coll)
مَعزاية	one (or more) goat(s)
مَعزور/مَعذور	excused
مَعزول	lonely, isolated, dismissed, sacked, fired
مَعزوم مَعازيم	invited, guest
مَعْزوم،مَعْزومة،مَعْزومين	invited
مُعَسكَر	(military) camp
مَعسول	sweet (as honey)
مَعسوم	protected, immune
مَعصارة،مَعاصَر	press (for extracting juice, oil, etc)
مُعطى	piece of data/information, datum
مُعظَم	majority, most
مَعفي	exempt
معَقَّد	tied with several knots, knotted, complicated, complex, suffering from a complex
مَعْقول	makes sense
مَعكرونة	macaroni
مَعكوف	crooked, bent
مَعلاق	pluck (organs used as food)
معَلَّب	tinned, canned
معَلَّبات	canned foods
مَعْلِش	nevermind
معَلَّق	hanging, suspended
مُعَلَّق	commentator
مَعلَقة،مَعالَق	spoon
مَعْلَقة،مَعالق	spoon
معَلَّم	teacher, master of a trade
مَعلوم	known, obvious, of course! naturally!
مَعلوم،طَبعًا	of course
مَعلومات	information, data
مَعماري	building (adj)
مَعمَدان،يوحَنّا اْلمَعمَدان	baptist, John the Baptist
مَعمَل،مَعامَل	factory, works, workshop
مَعْمَل،مَعامِل	factory
مَعمودِيّة	baptism
مَعمول	made, a pastry
مَعْمول،مَعْمولة،مَعْمولين	crafted
مَعنَوي	relating to meaning, spiritual, moral
مَعنَوِيّات	morale
مَعنى،مَعاني	meaning, significance
مَعنَى،مَعاني	meaning
مَعْنى،معْنة،مَعاني	meaning
مَعني	interested, concerned
مَعهَد،مَعاهَد	institute, institution
مِعيار،مَعايير	criterion, norm, standard, (good) example
مَعيشة	way of living, lifestyle
مُعيل	breadwinner
مُعَيَّن	(a) certain, particular
مُعَيِّن،مُعَيَّنة،مُعَيَّنين	specified, particular, specific, definite
معَيّي	much (in some areas)
مغارة،مُغُر/مَغايَر	cave
مُغامَرة	adventure
مغاوَزة	favoritism
مغَبَّر	dusty
مغَبَّش	blurred, blurry, indistinct, fuzzy
مُغتَصَب	rapist
مَغدور	murder victim
مَغرَب	sunset, evening, the west, Morocco, the Maghreb
مُغرَب	evening
مُغرَبِيّة	couscous
مَغرور	conceited, boastful
مُغري	tempting, enticing, alluring
مَغزة	meaning, moral
مُغَزّي،مُغَذّي،	nutritious
مَغسَلة/مَغسَل،مَغاسَل	washbasin
مغَلَّف	envelope
مَغلَواني	charging high prices, expensive, pricy
مَغلوب	defeated, vanquished
مَغْلي،مَغْليّة،مَغْلِيين	boiled
مَغنَطيس	magnet
مَغنَطيسي	magnetic
مغَنّي	singer
مُغَّيط	rubber bands, elastic bands (coll)
مُغَّيطة	rubber band, elastic band
مغَيَّم	cloudy, overcast
مُفاجَأة	surprise
مُفاجَئة	surprise
مفاصَلة	bargaining, haggling
مُفاوَضات	negotiations [official] talks
مُفتاح،مَفاتيح	key, electrical switch
مُفتَاح،مَفَاتِيْح	key
مفَتَّح	open-eyed, able to see, open minded
مُفتَرَق	junction, crossroad
مُفَتَّش	inspector, supervisor
مُفتَعَل	simulated, artificial, spurious
مَفْتوح،مَفْتوحة،مَفْتوحين	opened
مفَخَّخ	booby-trapped
مفَخفَخ	pompous, over-elaborate, affected
مُفَخَّم	treated with great respect, emphatic (grammar)
مَفَرّ	escape, flight
مُفرَد	single, detached, singular (grammar)
مِفرَد	odd (number)
مفَرَّز	frozen
مُفرَغ	vicious?
مُفَرَّق	retail (separated)
مَفرَق،مَفارَق	crossroads, intersection, junction
مَفروض	committed, supposed, expected, presumed, imposed
مَفشول	having failed
مَفصَل،مَفاصَل	joint (anatomy), hinge
مُفَصَّلة	hinge
مِفطَر	having had breakfast
مفَطَّس	stinking, rancid, putrid
مَفعول	influence, effect, validity (of a document or something)
مفَقفَل	blistered
مَفقود	lost
مَفْقود،مَفْقودة،مَفْقودين	lost
مفَكّ	screwdriver
مُفَكَّر	thinker
مُفَكِّرة	diary, appointment calendar
مَفكوك	untied, dislocated
مَفلوج	paralyzed
مَفْهوم،مَفْهومة	(thing) understood
مَفهوم،مَفاهيم	understood, concept, idea, meaning
مُفَوَّض	authorized agent, proxy
مُفيد	useful, instructive, interesting
مُقابَل	recompense, for, in exchange for, as compared with
مُقابَلة	interview, official meeting
مُقارَنة	comparison
مقاصَص	punished, in punishment, in detention (?)
مُقاطَعة	boycott, interruption, shortcut, area, region, district, the Muqata'a (PA's seat of government)
مَقالة	article
مَقالة،مَقالات	article
مَقالي	fried food
مَقام	place, position, rank, tonality, mode (music)
مَقامة	a work of rhymed prose (arabic literary genre)
مُقاوَل	contractor
مقاوَلة	contract, piecework
مُقاوَمة	opposition, resistance
مَقبَرة،مَقابَر	cemetery
مَقبور	buried
مَقبول	acceptable, reasonable, popular, well-liked
مِقتة،مِقتاي	melon field, cucumber patch
مُقتَرَح	proposed
مُقتَطَف	excerpt, extract, selected piece, selection, picking?
مقَحمَش	crispy
مِقداف،مَقَديف	oar
مَقْدَح	drilling machine
مَقدَح،مَقادَح	drill
مَقدِرة	ability, capability, capacity
مُقَدَّس	holy, sacred
مَقدِسي،مَقادِسة	Jerusalemite
مُقَدَّم	lieutenant colonel, the first installment of the dowry
مُقَدَّمة	foreword, preface, introduction, prologue
مَقدوح	drilled, has a hole in it
مَقَرّ	place of residence, center, seat
مقَرمَز	crouching
مقَرَّن	cuckold
مقَزَّز	icy, frosty (of ground?)
مَقسوم	divided
مقَشَّب،مقَشّبة	callused
مقَصّ	scissors
مقَصَّد	deliberate, intentional
مقَصَّر	insufficient, shortened
مَقصود	the person or object intended, intention, aim, objective
مقَطَّر	distilled
مَقطَع/مَقاطَع	section, extract, excerpt, paragraph, syllable
مَقطوع	cut off
مَقطوعة	piece (of music, poetry, etc)
مُقعَد	disabled, handicapped, disabled person
مَقعَد،مَقاعَد	seat, bench, dock
مَقلَب،مَقالَب	(practical) joke, prank
مقَلَّد	copy, imitation, copied, imitated
مُقْلِق	worrisome, disturbing
مقَلقَز	unsteady, wobbly
مقَلَّم	striped
مَقلوب	upside down, inside out
مَقلوبة	maqlubeh, an upside down layered dish of things
مَقلى،مَقالي	frying pan
مَقلي	fried
مَقمَرة	casino
مقَمَّل	infested with lice
مُقنَع	convincing
مقَوَّر	hollowed out, scooped out, low-necked
مَقوَرة	corer (for hollowing out fruit/vegetable)
مِقياس،مَقاييس	measure, indication, criterion, norm
مقَيَّد بِالوَقت	limited by time
مُقيم	resident
مُكافَحة	struggle, combat, combating
مُكالَمة	phone call
مَكانة	position, status, standing
مُكَبَّر	making bigger, magnifying, amplifying, exclaiming
مَكبوت	repressed, restrained, introverted
مَكّة،مَكّة اْلمُكَرَّمة	Mecca, Revered Mecca
مكَتّة	ashtray
مُكتَسَب	acquired, not innate/born
مُكتَشَف	discovered, discovery
مَكْتوب،مكْتوبة،مَكتوبين	written
مُكتَئَب	depressed
مُكَثَّف	intensive, concentrated, dense
مكَرسَح	disabled
مكَركَب	messy, a mess
مَكسَب،مَكاسَب	profit, gain
مكَسَّر	broken, pleated (skirt)
مَكسور	broken, backlog, work left undone
مكسور،مَكْسورة	broken
مكَشَّر	frowning
مَكشوف	bare, uncovered, open, exposed
مكَعَّب	cubed, cube, cubic, building block
مكَعوَك	frizzy
مَكفوف	blind
مكَلبَش	handcuffed
مُكَمّْل	supplementary, complimentary
مْكَمّل،مْكَمّلة،مْكَمّلين	having completed
مُكَنسة،مَكانَس	broom
مُكُنسة،مَكَانِس	broom
مكَنفَش	unruly (hair)
مكَهرَب	electrified
مِكواي،مَكاوي	iron (for ironing clothes)
مَكّوك	shuttle
مَكوى،مَكاوي	iron (for ironing clothes, soldering, etc)
مَكوِي	ironed
مُلاحَظة	comment, remark, note
مُلازَم	lieutenant
مَلّاك	landowner, proprietor, property owner
ملاك،ملايكة	angel
مُلاكَم	boxer
مُلاكَمة	boxing
مَلامَح	features, looks, outward appearance
مَلان	full
ملَبَّس	candies (coll)
مْلَبَّسة	candy
مُلتَحِمة	conjunctiva
مُلتَزَم	committed (to an ideology etc)
ملَتَّم	veiled, masked
مَلتينة	putty
مُلَثَّم،مُلَثَّمة،مُلَثَّمين	veiled, masked
مَلجَئ،مَلاجَئ	shelter, refuge
مِلِح	salt
مُلحَق	attaché, supplement
مَلحَمة،مَلاحَم	butcher's shop
مُلّحَّن	composer
مَلحوظ	perceptible, noticable
مُلَخَّص	summary
مَلزَمة،مَلازَم	vice, clamp
مَلزوزين	crowded together
مَلعون،مَلاعين	cursed, damned, clever (person), cunning rascal
مَلْعون،مَلْعونة،مَلْعونين	something cursed, cunning, damned
ملَغمَط/ملَغمَز/ملَغبَط	dirty, smeared
مَلغوم	mined (with landmines)
مَلَفّ	file, record
ملَفَّقة	fabrication, fabricated, made up
مَلفوف	wrapped, wound, coiled, cabbage
مَلقَط،مَلاقَط	pincers, tweezers, tongs
مَلَك	king (chess)
مُلك،أَملاك	property, possessions
مَلَك،ملوك	king
مُلْك،أمْلاك	property
مَلِك،مُلوك	king
مَلَكة	queen
مَلَكِة،مَلَكَات	queen
مَلَكي	royal, regal, kingly, monarchic
مَلَكِيّة	monarchy
مُلكِيّة	ownership
مَلَل	boredom
مَلموس	perceptible, tangible, discernable, noticable, touchable
مَلهى،مَلاهي	place of entertainment, club, etc
مُلَوَّث	polluted
ملَوَّح	stiff, having a stiff neck, backache, etc
ملوخِيّة	wild jute
ملَوَّن	colored
مَلْيان\مَلان،مَلْيانة،مَلْيانين	full
مليح	good
مَليون،مَلايين	million
مَليونَير	millionaire
مِمّا	than - used before verb
مُمارَسة	practice, (practical) experience
مُمارَسة	practical experience
مُماطَلية	runaround, stalling, obstructiveness, temporizing
مُمتاز	excellent
مُمتَع	enjoyable, interesting
مُمَثَّل	representative, actor
ممَخَّخ	brainwashed
مَمَرّ	crossing, passage, access
مُمَرَّض	nurse, paramedic
مَمزوع	torn
مَمسَحة،مَماسَح	duster, floorcloth
مُمكِن	possible
مُمَلّ	boring
مَملَحة،مَمالَح	salt cellar, salt shaker
مَملَكة،مَمالَك	kingdom
مَمْنوع،مَمْنوعة	prohibited
مَمنون	grateful
مُمَوَّل	funder, financial backer
مَمَّي	food, eat up!, (baby talk)
مِن	from, since
زَمان	long time
كُتْر	for <doing> so much
مَناخ	climate
مَنارة	lighthouse
مناسَب	suitable, appropriate, proper
مُناسَبة	opportunity, occasion
مُناسَبة،مُناسَبات	opportunity, occasion
مَناعة	immunity
مُنافَس	opponent, competitor
مُنافَسة	competition
مَنافَع	bathroom, lavatory, toilet, washroom
مُناقَشة	invitation to tender, public invitation to submit bids (for a piece of work)
مَناكير	manicure, nail polish
مناوَب	on call, on duty, duty- (adj)
مُناوَبة	alteration, rotation, shift
مُناوَرة	manoeuvre, stratagem, tactic, trick
مُناوَلة	communion (christianity)
مَنبَر	minbar, pulpit, podium, rostrum
منَبَّه	alarm clock
مُنَبَّه	stimulant
مُنتَج	product
مُنتَج	manufacturer, productive
مُنتَخَب	elected representative
مُنتَشَر	widespread
مُنتَظَر	expected, anticipated
مُنتَظَم	regular, ordered, fixed, methodical
مُنتَهى	limit, extreme, maximum
مَنتوج	product
مَنجَل،مَناجَل	scythe, sickle
منَجَّم	astrologer, stargazer, starry (of sky)
مَنجَم،مَناجَم	mine (minerals, resources, etc)
مَنجور	the wood finishings of a building
مِنحة،مِنَح	grant, stipend, award
مُنحَدَر	slope
مَنحوس	unlucky, ill-omened, mischevious, problematic, rascal
مُنخار	nostril, nose
مُنخُل،مَناخَل	sieve, fine mesh, netting
مُندَفَع	impulsive, hot-headed
مَندَل	circle where people sat trying to tell the future, crystal ball, fortune telling
مَندَلينة	tangerines
مُندَمَج	inserted, integrated
مَندوب	delegate, representative
مَنديل،مَناديل	kerchief, shawl
مِنَزوي	isolated, secluded, remote
مِنسَجَم	in keeping with, in harmony with, well-integrated
مَنسَف،مَناسَف	large tray or platter for serving food, OR Mansaf
مَنسوج	woven, textile
مِنشار،مَناشير	saw
مِنْشان	for
منَشّة	fly swatter
مُنَشَّط	tonic, stimulant, pick-me-up
مَنشَفة،مَناشَف	towel
مَنشور،مَناشير	published, publication, leaflet, pamphlet
مَنصَب،مَناصَب	position, post, office
مَنَصّة	platform, stand, stage, podium
مُنصَف	just, fair, equitable
مَنطَق	logic
مَنْطِقة،مَناطِق	area
مَنطِقي	logical
مِنطوي	self-centered, introverted
مَنْظر	view, sight, scene
مَنظَر،مَناظَر	view, sight
مُنَظَّم	organizer
مُنَظَّمة	organization
مَنع	prevention, prohibition
مِنَعزَل	cut off, isolated
مُنفَتَح	open, open minded
مَنفَر،مَنافَر	way out, exit
مِنَفرَد	isolated, separate, detatched, excluded
مِنَفعَل	upset, excited
مَنفول	scattered, strewn, all over the floor
مَنفى	(place of) exile
مُنقار،مَنَقير	beak
مِنقَرة	corer
مُنقَز/مُنقَذ،	lifeguard
مَنقَل،مَناقَل	brazier
مُنكَر	reprehensible, blameworthy, objectionable, unacceptable
مَنكوش،مَناكيش	pick, pickaxe
منَمَّر	numbered
مِنهَج،مَناهَج	way, method, program
مَنهوب	looted
منوزَل	having a runny nose
مُنَوَّع	varied
منَوَّم	soporiphic, narcotic, hypnotist, sleeping pill
منيح،مناح	good, well, etc
مْنيح،مْنيحة،مْنيحين	good, well
مَنيَك	pervert, sexual deviant, fucked
منَين	where from?
مَنيوك	fucked, faggot
مُهاجَم	attacker, assailant, forward (sport)
مَهارة	skill, expertise
مَهبَل،مَهابَل	vagina
مَهبول	stupid fool
مَهتري	worn out
مَهجَر،مَهاجَر	abroad, diaspora, place of emigration
مَهد	cradle
مُهَدّي	calming, soothing, sedative
مَهر،مُهور	bride price, dowry
مُهَرَّب	smuggler
مُهَرَّج	clown
مَهرَجان	festival
مَهري	worn out, tattered, ragged, in rags
مَهل	slowness, leisureliness, leisure
مُهلة	(period of) time, respite
مُهْلة،مِهَل	respite, period of time, some time
مُهِمّ،مُهِمّة،مُهِمِّيْن	important
مَهما	whatever
مُهِمّة	assignment, task, mission, duty
مُهمَل	neglected, negligible
مهَندَز	well-dressed, elegant
مهَندَم	well-dressed, elegant, chic
مِهَني	professional, vocational
مو،مش	not
مُواجَب	perservering, assiduous, persistent
مُواجَبة	application, perseverance, persistence, diligence
مُواجَهة	encounter, confrontation, clash
مُؤاخَذة	blame
موارَبة	crookedness
مَواسَرجي	plumber
مُواصَلات	transport
مُوافَقة	agreement, consent
مَوّال	type of popular arabic song
موبِليا	furniture
مؤتَمَر	conference, congress
مَوجة/موجة،أَمواج/موج	wave
موجَز	summarized, summary
موَجَّه	directed, aimed
موَجهَن	hypocrite
موجود،موجودة،موجودين	present
موَحَّد	united, uniform
موَحَّل	muddy
موَرَّم	swollen
مَوروب	crooked, askew, grumpy, in a bad mood
موزة،موز	banana
مؤزي	harmful
موسطَرة	sample
مُؤسِف،مُؤسِفة،مُؤسِفين	unfortunate, distressing, regrettable
مَوسَم،مَواسَم	season
موَسوَس	obsessed. phobic, anxiety ridden
مَوسوعة	encyclopedia
موسيقًى\موسيقًة	music
موش،مواش	razor, pen knife, flick knife, switchblade
موَشَّم	tattooed
مُوَصَّل	conductor (electricity etc)
موضوع،مَواضِيْع	subject
مَوعَد،مَواعَد/مَواعيد	(appointed) time/date
مُوَفَّق	successful, fortunate, happy
موَقَّت	temporary, temporarily, time-, timed
مَوقَع،مَواقَع	position, post, (web)site
مَوقَف	bus stop, taxi rank
مَوقَف،مَواقَف	position, attitude, opinion, bus stop
مَوقَف،مَواقِف	bus stop
مَوكَب،مَواكَب	procession
مَولَد	birth
مُوَلَّد	obstetrician, generator
موَلَّع	lit, alight
مَولود،مَواليد	born, from, of
مونة،مُوَن/مُؤَن	supplies, food, staples
مَوهِبة،مَواهَب	talent
مَوهوب	talented
مَيّ/مَيِّة،مَيَّات	water
مَيّ\مَيّة،مِيّات	water
مَيّال	inclined, tending, having a tendency
مِيّة	hundred
مَيتَم،مَياتَم	orphanage
ميثاق،مَواثيق	charter, covenant, pact
مَيدان	field - (adj)
ميْدَنة،مآدَن/مَيادَن	minaret
ميزان،مَوازين	scale, scales, weighing machine, balance
ميزانِيّة	budget
ميعاد،مَواعيد	date, appointed time, appointment, promise
ميْل،مُيول	tendency, trend, bent, inclination, tilt, slope, diagonal
مَيَّل!ء	come in!
ميلاد	birth, the birth of Jesus
ميلادي	birth- (adj)
مينة	enamel, dial (of watch), port, harbor
مينما/مين ما	whoever
مَيّو	swimming costume
مَيئوس	despaired (of), desperate
نابغة،نَوابَغ	(a) genius
نابلَس	Nablus (city)
ناجَح	successful
ناجَع	useful, beneficial, efficacious
ناحة،ناحات	side, aspect, point of view
ناحية،نَواحي	side, aspect, point of view, standpoint
ناخَب	voter
ناخَب،ناخْبة،ناخْبين	voter
نادَج/أَنداج	ripe, mature, grown up
نادَر	rare, unusual, uncommon, one who has made a vow
نادرة،نَوادَر	unusual occurrence, rare phenomenon, strange thing, amusing anecdote, curious tale
نادي،نَوادي	club
نَازْل،نازْلة،نازْلين	coming down (act), getting off
ناسي،ناسية،ناسين	forgot
ناشَف	dry
ناشِف،ناشْفة،ناشْفين	dry
ناصَح	fat, plump
ناصرة،الناصرة	Nazareth
ناضْرة،نَواضِر	anecdote
ناضور	binoculars, scope
ناطَق،الناطَق بِلِسان	spokesman
ناطور،نَواطير	watchman, warden
ناعَم،أَنعام	soft, fine, delicate, smooth
نافَع	effective, useful, helpful, beneficial
نافِع،نافْعة	useful, effective, beneficial
نافَق،نافقة	in demand, selling well
ناقَد،نُقّاد	critic
ناقَص	lacking, incomplete, missing, minus
ناقِص،ناقْصة،ناقصين	lacking, defective
ناموس	mosquito(s)
ناموسة،ناموسات،ناموس	mosquito (es)
ناموسِيّة	mosquito net
نامي	growing, developing
ناوي	the nuclear tests
ناي	flute, esp. traditional flute made of camboo or cane
نائَب،نوّاب	deputy, substitute, representative, delegate, member of parliament or congress, etc
نايَم	asleep, resting, having a rest, lying down (but not necessarily sleeping)
نايِم\غافي،نايِمة\غافْية،نايِمين\غافْيين	asleep
نَبات	plant(s)
نَباتي	vegetable, vegetarian
نَبّاشة	pick
نَبتة	a plant
نَبرة	tone, intonation
نَبض	pulse
نَبَع،نبوعة	spring, source
نُبَل	nobility, magnanimity
نَبّوت،نَبابيت	club, truncheon, billy club
نَبي،أَنبِياء	prophet
نبيد	wine
نَبيل،نُبَلاء	noble
نَتيجة،نَتايَج	result, outcome, upshot, consequence, bottom line(?)
نَتيجة،نَتايِج	result
نَثر،نَتر	prose
نَجات	rescue, deliverance, salvation
نَجاح	success
نَجّار	carpenter, joiner
نجارة	joinery, carpentry, wood shavings
نجاص،نجاصة	pear(s)
نَجاعة	efficacy, effectiveness
نَجدة	help, aid, support, reinforcement(s)
نِجمة،نجوم	star
نجيل	couch grass, Bermuda grass, common stargrass
نحاس	copper
نَحت	sculpture, sculpting
نَحس	bad luck, misfortune
نَحْلة،نَحْل	bee
نَحو	part, direction, syntax
نَحوى	towards, in the direction of, about, approx.
نَحيف،أَنحاف	thin, slender, reedy
نخاع	marrow, brain
نخاعات	brains (as food)
نخالة	bran
نَخَب	toast, a toast, as in with drinks etc
نُخبة	elect, elite, the best, the pick, the cream of the crop
نَخلة/نَخلات/نَخل	palm trees
نَخوة	nobility, generosity, bravery, self-sacrifice
نَدّابة	(professional female) mourner
نَدامة	regret, remorse
نَدب	wailing, lamentation
نَدة	dew
نِدر،ندورة/نُدور	vow
نَربيج،نَرابيج	flexible pipe, tubing
نَرويج	Norway
نَرويجي	Norwegian
نِزاع	struggle, conflict
نَزلة	descent, downhill slope
نَزيف	bleeding, hemmorage
نِسان	April
نِسائي	women's, pertaining to women
نَسَب	family relationship, geneology
نِسبة	relation, proportion, ratio, extent, degree, rate
نِسبي	relative, proportional
نُسخة،نُسَخ	copy
نُسْخة،نُسَخ	copy
نَسخي	a type of Arabic caligraphy
نِسر،نسورة	eagle, vulture
نَسَل	procreation, progeny
نَسَمة	person, soul
نِسناس،نَسانيس	mongoose (or in some areas a small type of monkey)
نِسيان	forgetfulness
نَسيب،نَسايَب/نَسائَب	relation by marriage, in-law
نَشا	starch
نَشّابة،نَشّاب	arrow (archery)
نشارة	sawdust
نَشاط	activity, animation, vivacity
نَشّاف	blotting paper
نَشّال	pickpocket
نَشر	hanging out the washing, publication, sawing
نَشرة	edition, announcement, bulletin
نَشوة	bless you! (said to someone who sneezed)
نشوفة	hardening, toughening (drying out)
نَشَوِيّات	carbohydrates, starchy foods
نَشيد،أَناشيد	song, anthem
نَشيط	active, energetic, animated, vivacious, full of life
نُصّ	half
نُصّ،أَنصاص/نصاص	half, middle
نَصّ،نُصوص	text, version
نَصّاب	swindler, con man, trickster, ripoff artist
نَصاحة	fatness, obesity
نَصّاطة	stethoscope
نُصّاني	middle (adj)
نُصُب،أَنصاب	monument
نَصراني،نَصارة	Christian (مسيحي more common)
نَصراوي،نَواصرة	person from Nazareth
نَصلة	blade, spearhead
نَصيب	luck, fate, chance
نُصِّيّة،نَصاصي/نُصِّيّات	small watering can
نَصيحة،نَصايَح/نَصائَح	advice
نَضَّارات	eye glasses
نَضافة	cleanliness
نُضوج	maturity
نضيف،نضاف	clean
نَضيف،نَضيفة،نْظاف	clean
نطاق	vomiting
نِطاق	limit, scope
نَطّة،نَطّات	jump, leap
نِظام	regime
نِظام،أَنظِمة	system, order, organization, regime
نَظَر	sight, view, attitude, opinion
نَظْرَة	sight, opinion
نَظرة،نَظَرات	glance, view, attitude, theory
نَظَري	theoretical
نَظَرِيّاً	theoretically, in theory
نَظَرِيّة	theory
نَعامة	ostrich
نَعجة،نَعجات/نعاج	sheep
نَعسان	tired, sleepy
نَعش،نعوش	bier(?) at Muslim funeral
نَعَل،أَنعال	sole (of shoe)
نَعَم	yes, pardon, what?, alright ready
نِعمة،نِعَم	benefit, blessing, favor, grace
نَعنَع	mint
نَعي	death notice, announcement of death
نَعيماً	pleasurable! (said to someone who had a shower, haircut, etc)
نغَرَّي	said to cute babies
نِغَش،نِغشة	nice, cute, sweet
نَغَش،نَغشة،أَنغاش	cute, sweet
نَغمة/نَغَمة	tone, tune, melody
نَغنوش	cute, adorable, sweet
نَفّاس،طَيّارة نَفّاسة	jet plane
نَفاقة	expense, alimony
نِفتة	a little bit
نَفَر،أَنفار	person, individual, soul (in statistics, etc)
نَفس	self, soul, mind, desire, appetite
نَفساني	psychological, mental
نَفسي	psychological, mental
نَفط	(crude) oil
نَفَل	windfall (fruit which has fallen from the tree before it's ripe, and therefore is of inferior quality), loose, not packaged, in bulk
نفورة،نَوافير	fountain
نُفوز/نُفوذ	effect, influence
نَفي	exile, banishment, deportation, negation
نِقابة	trade union
نِقاش	discussion, debate
نَقّاق	complainer, grumbler
نَقّال	portable, mobile, movable
نَقانَق	sausage
نَقَب/النَقَب	the Negev
نَقد	criticism, cash
نَقدي	critical, monetary, cash, in cash
نَقش	engraving
نَقص،نَواقَص	lack, shortage, fault, shortcoming, defect, disadvantage
نُقطة،نُقَط/نِقاط	drop, point, dot, diacritical point, period, full stop, post, station
نَقلة	transfer, trip, load
نقوت	gift of money, jewellry, etc, presented by parents to a couple who just got married, had a baby, or bought a new house
نَقيب،نُقَباء	captain (mil)
نُقَّيفة،نُقّافة	slingshot
نَكبة	catastrophe, calamity
نُكتة،نُكُت	joke
نُكْتة،نُكَت	joke
نُكَتجي	joker, teller of jokes
نِكَد،نِكدة،نِكدين	cranky, angry
نُكران	denial
نَكسة	relapse
نِمر،نمورة	tiger, leopard
نُمرة،نُمَر	number (in a list or series)
نِمس	ferret, weasel, marten, slimy character
نِمسا،النِمسا	Austria
نِمساوي	Austrian
نَمَش	freckles
نَمَط،أَنماط	way, fashion, style, manner
نَملة،نَملات،نَمَل	ant(s)
نَمْلة،نَمْل\نَمْلات	ant
نُمُوّ	growth, development
نُموزَج،نَمازَج	model, specimen, sample
نُموزَجي	model - (adj), exemplary
نَميمة	slander, malicious gossip
نِنّة	sleep (said of/to children)
نْهار	day
نهار،نهارات	daytime, day
نِهاية	end, conclusion
نِهائي	final
نِهائِيّاً	finally
نَهَب	looting
نَهر،أَنهار	river
نَهي	prohibition
نهيق	bray (of donkey)
نَوّاسة	night light, dim light
نَواشَف	cold food, snacks (as opposed to cooked food)
نوبة/نَوبة،نوبات	attack (of an illness, especially heart attack), shift, time, instance
نوت،نوتة،نوتات	note (music)
نوح	wailing
نَوَر	gypsies, roma
نَوَري/نوري	a gypsy, a roma
نول	loom
نوم	sleep
نومة	(a) sleep
نونو	small, tiny, little bit (children's speech)
نونِيّة	potty, chamber pot
نَوَوي	nuclear
نَيّ	raw, uncooked
نِي،نَي	raw, uncooked
نَياظ	ease, comfort, luxury
نِيّال	lucky (used with attached pronouns)
نِيّالك	Good luck
نِيّالهُ	he's lucky
نِيّة،نِيّات\نَوايا	intention
نير	yoke (farming)
نيس	porcupine
نيشان،نَياشين	target, medal, trophy, decoration
نيع	mouth (of animal)
هات،هاتي،هاتو	give! bring!
هات،هاتي،هاتو	give!
هاتَف	telephone
هاتَفي	telephonic
هادي	calm, quiet
هادي،هادْية،هاديين	quiet, calm
هال	cardamom (in some areas)
هالْزَّتونات	these olives
هالقَد	this/that much
هالقَدّ/هالقدّة	so, so much, to such an extent
هالقَيت	now
هالوَلَد،مِتبَنّينهُ	this child, they're his adoptives
هامَش،هَوامَش	margin
هامَل،هاملة،هاملين،هُمَّل	badly behaved, lout, yob, hooligan
هامِل،هامْلة،هُمّال\هامْلين	badly behaved, ill mannered, neglected
هان	here (rural form of هون used in Jerusalem and elsewhere)
هاوَن	mortar (bowl for grinding)
هاوي،هُواه	ameteur, lover, fan (of arts, sports, etc)
هايَج،هايجة	rough, stormy
هائَل	terrifying, appalling, dreadful, enormous, huge tremendous
هَبّة	gust
هِبة	grant
هَبر،الهَبر	lean meat
هَبلانة	stupidity, foolishness
هُبوط	sinking, drop, decrease, landing
هَبيان	worn out
هُتاف	shouts, cheers, acclamation
هِجائي	alphabetical
هِجرة	emigration, immigration, the Hijra (emmigration of Mohammed from Mecca to Medina)
هِجري	pertaining to the Hijra
هِجنة	strange thing
هُجوم	attack
هَجين،هُجَنا	strange, odd, peculiar, queer
هَداك،هَديك	that
هَدَف،أَهداف	target, purpose, objective, goal
هَدلاك	those
هُدنة	ceasefire, truce, armstice
هُدهُد	hoopoe
هَدول	these
هُدوئ/هُدُوّ	quiet, peace, tranquility
هَدِيّة،هَدايا	present
هَدِيّة،هَدايا	gift
هَرَم،أَهرام،أَهرامات،هرامات	pyramid
هَريسة	a kind of semolina pudding
هَزَّة	shock, jolt
هَزّة،هَزّات	shock
هَزَلي	funny, humorous, comic
هَزيمة،هَزائَم	defeat
هَسَّع	now (in some areas), abbreviated form of هالساعة this hour
هِسهَس	a type of small gnat or biting midge
هَشّات/هَشّيت	braggart
هَضبة/هَضَبة	plateau
هَضم	digestion
هَلا،يا هَلا!ء	welcome (in rural speech)
هَلّأ\هَلَّق،هَلْقَيت،إسّا	now
هِلال	new moon, crescent, (bracket)
هَلحين	now (in villages in the Jerusalem region)
هَلَّق	now
هَلكان	worn out, exhausted
هُلَند،هولَندا	Holland
هَلّي	like, هٰ(ها إ)لّي, he who, she who, the one who..
هَمّ،هُموم	worry, concern, care
هَمالة	rowdyism, yobbishness, loutishness, hooliganism
هِمّة	energy, power, zeal, enthusiasm
هَمزة	hamza ء
هَنا	enjoyment
هُناك	there
هَنة	enjoyment
هَندَسة	engineering
هَندَسي	geometric, geometrical, related to engineering
هَنِيّان	your health (good wishes to a person who's just had some water)
هَوا	wind
هْواي	blow
هَوّاية	fan
هِواية	hobby
هِواية،هِوايات	hobby
هُوّة،هُوّات	abyss
هَوى	air, wind, breeze, love, desire
هَوِيّة	identity, ID card
هَوِيّة،هَوِيّات	identity
هوَيَّن،هوَيّنة،هوَيّنين	easy
هَيبة	respect, awe, reverence, prestige
هَيطَلِيّة	cereal
هيك	so, such, like this
هَيكَل،هَياكَل	skeleton, framework, chassis, altar
هَيل	cardamom
هَيَّن،هَيّنة،هَيّنين،هَيّنات	easy
هَيُّه،هَيْها،هَيْهُم	Here he/she/it is
هَيئة	form, (outward) appearance, (official) body, organization, group, staff
و	while
واثَق	trusting (a.p.)
واجَب،واجبات/واجِبات	duty, obligation, task
واحة	oasis
واحَد،الواحَد	
واحَد،أوَّل	one
واحَد/واحدة	one, unit, someone
واد،وِديان	ravine, valley, gully
واد،وِديان	valley
وادي	valley
وارَت/وارَث/وَريس/وَريث	inheritor, heir
وارَم	swollen
واسطة/واسِطة،وَسائَط	means, mediation, intermediary, go-between, broker, connections, pulling strings
واسَع	wide, spacious, comprehensive
واضَح	clear, distinct, obvious
واطي	low (in all senses), base, inferior, coarse, immoral
واطي،واطية،واطيين	low
واعة	container, receptacle, bowl
واعي	conscious, awake, aware
واقَع،واقعة،واقعين	lying (after a fall), fallen
واقَع،وَقائَع	real, true, reality, fact
واقِعي	realist, realistic
واقَف	standing, upright, stopped, not going, not working
واقِف،واقْفة،واقْفين	standing
وَإِلّا	if not, otherwise
والَد/والدة،والِديْن	father/mother
واوا	boo-boo, pain (baby talk)
واوي،واوِيّة	jackal
وَباء	epidemic
وَتَد،أَوتاد	peg
وَتَر،أَوتار	string
وَثائِقي	documentary
وَثيقة،وَثائَق	document
وَجاهة	credit, esteem, prestige, standing, delegation, deputation
وَجبة	course (of meal), meal, dise/hit (of drug)
وَجَع،أَوجاع	pain
وَجَع،أوجَع	pain
وِجْه	face
وَجهَنة	hypocrisy
وُجود	presence, existence
وَحداني	single, solitary
وَحدة،وَحدات	unit
وَحدة/وُحدة	loneliness
وَحش،وُحوش	wild animal, uncivilized person, barbarian, animal
وَحشي	wild, savage, barbaric, brutal
وَحشِيّة	wildness, savagery, cruelty
وَحَل	mud
وَحمة	birthmark
وَحيد	only, sole
وِداع	parting, farewell, goodbye
وَرا	behind
وِراثة	heredity
وِراثي	hereditary
وَرّاني	back, rear, hind
وَرب	obliqueness, inclination
وَرد	roses, or flowers in general
وَرْدِي	pink
وَرشة،وُراش	workshop, builder's yard
وَرْشة،وَرشات	workshop
وَرطة	trouble, mess, plight, predicament
وِرك،أَوراك/وراك	hip
وَرَم	swelling, growth
وَرَندا/بَرَندا	veranda
وَريد،أَورِدة	vein
وَزّ	geese (coll)
وَزّة	a goose
وَزَن،أَوزان	weight, form, class, pattern (verb)
وَزنة	a weight
وَزير،وُزَراء	minister
وَساع	expanse, space, capacity, comfort, ease
وُسَخ	dirty, immoral, obscene
وَسَخ،أَوساخ	dirt, also a euphemism for shit
وِسِخ،وِسْخة،وِسخِيْن	dirty
وَسَط،أَوساط	circle, society, milieu, surroundings, social sphere / environment, middle, average
وَسط/وُسط	center, middle
وَسْط\وَسَط،أَوساط	middle
وُسواس/وُسواسة	obsession, phobia
وَسيط،وُسَطاء	go-between, mediator, broker, middleman
وُسيع	broad, wide (some areas)
وَسيلة،وَسائَل	means, method, medium
وَشّ/وِجّ	alternative وِجه pronounciations
وَشّام	tattooist
وَشَم	tattoo
وَشوَشة	whisper, whispering
وَصف،أَوصار	description
وَصفة	remedy, prescription (particularly folk medicine)
وَصَل،وُصولة/وُصولات	receipt
وَصلة	extension cord
وَصمة	stain, blot, stigma
وَصي،أَوصِياء/وُصَياء	authorized agent, trustee, executor, legal guardian
وَصِيّة،وَصايا	order, command, commandment, will (last will and testament)
وَضَع،أَوضاع	situation, position
وَضْع،أَوضَاع	state, condition, situation
وَطَن،أَوطان	homeland, native land
وَطَن،أوطان	country
وَطَني	national
وَطَنِيّة	patriotism, nationalism
وَطوَط	bat (animal)
وَظيفة،وَظايَف/وَظائَف	post, position, job, homework
وِعاء،أَوعِية	container, receptacle, bowl
وَعد،وُعود	promise
وَعَر/وَعرة	rugged, rocky, difficult
وَعظ	preaching
وَعظة	a sermon
وَعَل،وُعول/أَوعال	ibex, mountain goat
وَعي	awareness, attention, wakefulness, consciousness
وِفاق	concord, agreement, harmony
وَفاه،وَفايات	death, decease
وَفد،وُفود	delegation
وِقاية	prevention
وِقائي	preventative
وَقت،أَوقات	time
وَقت،أوقات	time
وَقتي	temporary, in the meantime, (some areas) immediately
وَقف،أَوقاف	(Islamic?) endowment fund
وُقوف	stopping, parking
وِكالة	agency, representation
وَكيل،وُكَلاء	agent, authorized representitive, proxy, guarantor
وَلا	nor, and not, not even
وِلّا	or (used for mutually exclusive options), and there [he/she/it] is! and there he was!
وَلّا	Really!, By God!, I swear to God!
وِلّا	suddenly
وَلّادة	midwife
وِلادة	birth
وَلّاهي	by God!
وِلاية	state, province
وَلَد،وْلاد\أولاد	child
وَلدان	born
وَلدانة	childishness
وَلَك	you, hey you, what's all this, what are you up to, I'm warning you
وَلَو	even if.., come on!, forget it!, don't you dare!, oh really?!, wow!
وَلوَلة	wailing, howling, lament
وَلي،أَولِياء	protector, guardian, mentor, saint/holy man (Muslim)
وِنتى	when? (usually أَيْمتى is used)
وِنش	crane, winch
وَهَم،أَوهام	delusion, illusion
وَهمان	delusional
وَهمي	illusory, imaginary
ويْل	woe unto.. it'll be worse for..
وين\فين	where
يابان،اليابان	Japan
ياباني	Japanese
يابَس	dry, dried out
يابسة	land, dry land (as opposed to water
ياخور	small stable, dump, hole
ياريت	if only
يافا	Jaffa
ياما	mom! oh mom! oh, mom!
ياما	how [many]!, what a lot of.. !, how.. !
يانَصيب	lottery
يَتيم،أَيتام/يُتَماء	orphan
يَجَب	it must (more formal)
يَحيا	John (the baptist) (Muslim speech)
يَد،أَدي	hand (MSA)
يَدَوي	manual
يُرام	is wanted, is desired
يَسار	left
يَسوع	Jesus (Christian speech)
يَعْني	that's to say
يَلّا	come on! get a move on!
يَمّ	just right (just around the corner, right away, etc)
يِمكَم	maybe, perhaps, might be
يِمكِن	possible
يَمَن،اليَمَن	Yemen
يَمَني	Yemeni
يَمين	right (direction)
يَنسون	anise, aniseed
يَهودي	Jew, Jewish
يوجَد	there is, there are (formal)
يوحَنّا	Johm (the baptist) (Christian speech)
يود	iodine
يولاد	steel
يوم	day
الأحَد	Sunday
الأرْبَعة	Wednesday
التَلاتة	Tuesday
التِنين	Monday
الجُمْعة	Friday
الخَميس	Thursday
السَبْت	Saturday
يومها	that day, then
يَومي	daily
يومِيّة	daily wage, a day's pay
يونان	Greece, Greeks
يوناني،يونان	Greek
يَئس	despair, desperation
يَئسان	despairing, desperate
يِئسَت	she despaired
ييه\يي	Oh!
دُبَيّ	Dubai
أُرْدَن	Jordan
يَومي	daily
يومِيّة	daily wage, a day's pay
يونان	Greece, Greeks
يوناني،يونان	Greek
ييه\يي	Oh!
أمريكا	The United States, America
أَمْس	yesterday
مُؤَخَّر	delayed, deferred, recent, rear part, back, tail end
مُؤَخَّراً	recently, lately
فَور،فَوراً	immediately after
نور	light
طَرْقَة،طَرْقَات	knock
نار،نيران	fire (projectiles, bullets, etc.)
مَجْنون،مَجْنونة،مَجانين	crazy, insane, mad, obsessed, lunatic
ليرة،ليرات	Lira (currency)
عيلة،عائلة،عايلة،عِيَل،عِيال	family
صَبَّاط،صَبَابيط\صَبَبيط	shoes (pair of)
تْراكُم،تْراكُمات	pile, load
حانَق،حانْقة	up in arms, perturbed, fretting
حِسْبة	amount, sum, calculation, reckoning, math problem
ناقِم،ناقْمة،ناقْمين	disgruntled, hostile, angry
شوفَير،شوفَيْرِيِّة	driver, chauffeur
نِقْمة،نِقْمات/نِقَم	vengeance, revenge, retribution, hostility, rancor, spite, malice, resentment
كلاسيكي	classic
كلاس	classy
لبنان	Lebanon
مِصْر	Egypt
إفنت،إفِنْتس	event
نت	the internet