past	pres	form	def
آخَز	يأَخَز	3	to censure, condemn, blame, resent, be offended
آمَن	يآمَن	3	to believe
آنَس	يآنَس	3	to keep someone company
أَباد	يُبيد	4	to exterminate
أَبرَز	يِبرَز	4	to make prominent, accentuate, emphasize, highlight
أَبرَق	يِبرَق	4	to flash with lightning
أَبسَط	يِبسَط	4	to please, delight, gladden, make happy
أبْطَل	يبْطِل		to cancel, to void, to nullify, to disarm, to neautralize
أَبطَل	يِبطَل	4	to cancel, neutralize, dismantle, disarm
أبْعَد	يبْعَد		to move away, to move out of the way
أَبعَد	يِبعَد	4	to move something away, to banish/deport/expel
أَبَّن	يأَبَّن	2	to eulogise, deliver a funeral oration
أَتَّت	يأَتَّت	2	to furnish
أتّر	يؤَتِّر		to effect, to influence
أَتعَب	يِتعَب	4	to tire, wear out
أَتقَن	يتقن	4	to be proficient, know well, master
أَتلَج	يتلَج	4	to snow
أَثار	يثير	4	to arouse, awaken, raise
أَثبَت	يِثبَت	4	to prove, establish
أَثَّر	يأَثَّر	2	to influence, affect
أَجَّر	يأَجَّر	2	to rent out, rent to someone
أَجرى	يِجري	4	to hold, conduct, carry out
أجّل	يؤَجّل		postpone, delay
أَجَلّ	يجل	4	to honor, esteem
أَجَّل	يأَجَّل	2	to postpone, put off
أَجلى	يِجلي	4	to remove, evacuate (people)
أَحرَج	يحرج	4	to embarrass
أَحرَز	يِحرَز	4	to be worthwhile
أَحصى	يَحصي	4	to count, enumerate
أخَد	ياخُد		to take, to get, to receive
أَخرَج	يِخرَج	4	to take out, bring out, produce, direct
أخطى	يِخطي	4	to be mistaken, to miss (target)
أَخفى	يِخفي	4	to hide, conceal
أَخلى	يِخلي	4	to empty, to evacuate (place, area)
أَدَار	يدير	4	to manage, administer
أَدهَش	يِدهَش	4	to surprise, astonish, astound
أدّى	يؤَدّي إلَى		to lead to
أَدّى	يأَدّي	4	to carry out, perform, lead to, bring about, cause
أَراد	يريد	4	to want
أَرجَع	يِرجَع	4	to give back, put back, return
أرخى	يرخي	1	to lower, drop, relax, loosen, let down, let go
أَرشَد	يِرشَد	4	to guide, instruct, direct
أَرضى	يِرضي	4	to satisfy, please
أَركَن	يِركَن	4	to rely on, trust
أزْعَج	يزْعِج		to bother, to annoy, to bother
أَزعَج	يِزعَج	4	to annoy, disturb, bother
أزْعَل	يزْعِل		to anger, to upset
أَزعَل	يِزعَل	4	to upset, annoy
أَزى	يِئزي	4	to harm, hurt, damage
أَسرَع	يِسرَع	4	to hurry, be in a hurry, to drive quickly, speed
أَسَّس	يأَسَّس	2	to found, establish, set up
أسْقَط	يسْقِط		to cause to fall, to bring down, to shoot down
أَسقَط	يُسقَط	4	to cause to fall, bring down, shoot down
أَسكَر	يِسكَر	4	to intoxicate, make drunk
أسْلَم	يسْلِم		to submit, to surrender, to convert to Islam
أَسلَم	يُسلَم/يأَسلَم	4	to convert to Islam
أَشبَع	يِشبَع	4	to satisfy, gratify (appetite)
أَشتى	يشتي	4	to rain
أشّر	يؤَشِّر		to signal
أَشَّر	يأَشَّر	2	to signal, give a sign
أَشرَك	يِشرَك	4	to include
أَشعَل	يِشعَل	4	to set on fire
أصْبَح	يصْبِح		to awaken in the morning in a particular state, to become, to turn into
أَصبَح	يِصبَح	4	to be in the morning, to become, turn into
أَصدَر	يِصدَر	4	to bring out, issue, publish
أَصَرّ	يصَرّ	4	to insist, persist, stick to, be determined, be set on
أصْلَح	يصْلِح		to reconcile, to make peace between
أَصلَح	يِصلَح	4	to make peace, bring about reconciliation
أَضاف	يضيف	4	to add
أضْرَب	يضْرِب		to go on strike
أَضرَب	يِضرَب	4	to strike, go on strike
أَضعَف	يِضعَف	4	to weaken, undermine
أَطاع	يطيع	4	to obey
أَطلَع	يَطلَع	4	to take up, bring up, take out, bring out
أطلق	يطْلِق		to fire (weapon), to set off, to release, to send away
أَطلَق	يِطلَق	4	to release, set free, send, send away, discharge, set off, let off
أَظهَر	يَظهَر	4	to appear, to reveal/show
أَعاد	يُعيد	4	to return something, give something back
أَعجَب	يعجب	4	to please, satisfy
أَعدَم	يِعدَم	4	to destroy, execute, put to death
أَعدى	يِعدي	4	to be infectious/contagious, to infect
أَعرَب	يَعرَب	4	to parse, to express
أَعطى	يَعطي	4	to give
أَعفى	يِعفي	4	to exempt
أعْلَم	يعْلِن		to announce, to declare, to broadcast, to advertise
أَعلَن	يِعلَن	4	to announce, declare
أَعم	يِعمي	4	to blind, to dazzle
أَغرى	يِغري	4	to tempt, induce, seduce
أَفاد	يفيد	4	to benefit, be useful/beneficial/effective/advantageous, to interest
أَفرَج	يِفرَج	4	to release (from prison, custody, etc)
أَفشَل	يِفشَل	4	to foil, frustrate, thwart
أفِْطَر	يفْطَر		to break fast
أَفطَر	يِفطَر	4	to have breakfast, to break a fast
أفلَس	يِفلَس	4	to go bankrupt
أَقنَع	يِقنَع	4	to convince
أَكَّد	يأَكَّد	2	to assure, promise, confirm
أكْرَم	يكْرِم		to respect, to honor
أَكرَم	يِكرَم	4	to honor, respect, to host, treat hospitably
أَلَحّ	يلَحّ	4	to pressure, urge, implore
أَلغى	يِلغي	4	to cancel, invalidae, abolish
أَلَّف	يأَلَّف	2	to compose, write, draw up
أَلقى	يُلقي	4	to throw, drop, give, deliver (lecture/talk/speech)
أَلهى	يِلهي	4	to distract
أمَر	يؤمُر		to give an order, to command
أَمَر	يؤمُر	4	to order, command
أَملى	يِملي	4	to dictate
أَمَّم	يأَمَّم	2	to nationalize
أَمَّن	أَمَّن	2	to insure, to have confidence, to entrust
أمْهل	يمْهِل		to give some time, to give respite
أَمهَل	يِمهَل	4	to give someone time, grant respite
أَنّ	يأَنّ	1	to groan, moan
أَنجَز	يِنجَز	4	to achieve, accomplish, realize, put into practice, finish off
أنْحِف	يِنْحَف	1	to lower, drop, relax, loosen, let down, let go
أَنطى	يَنطي	4	to give (Galilee)
أنْعَم	ينْعِم		to bestow favor, to bless, to make pleasant
أَنعَم	يِنعَم	4	to confer, bestow, favor, make something pleasant
أَنقَذ	يِنقّذ	4	to save, rescue
أَنكَر	يِنكَر	4	to deny
أَنهى	يِنهي	4	to end, finish, put an end to
أَهان	يهين	4	to insult, offend
أَهدى	يِهدي	4	to dedicate, send, convey
أَهَّل	يأَهَّل	2	to welcome, say ahlan, to train, qualify, rehabilitate, consider suitable
أَهمَل	يِهمَل	4	to neglect
أَيَّد	يأَيَّد	2	to support, be in favor of
إبتَدى	يَبتَدي	8	to begin (unusual)
إبتَسَم	يِبتَسَم	8	to smile
إبيَضّ	يِبيَضّ	9	to become white(r)
إتَّحَد	يِتَّحَد	8	to unite (intrans)
إتَّخَذ/إتَّخَز	يِتَّخَذ	8	to take (incl. stance, decision, steps, measures)
إتَّصَل	يِتّصَل	8	to contact, get in touch, to telephone
إتَّضَح	يِتَّضَح	8	to become clear, become obvious
إتَّفَق	يِتَّفَق	8	to agree, reach an agreement, be in agreement
إتَّكَل	يِتَّكَل	8	to rely on, depend, trust in
إتَّكى	يِتَّكي	8	to lean (on, against)
إتَّهَم	يِتَّهَم	8	to accuse
إجتَرّ	يِجتَرّ	9	to chew, to chew the cud(??)
إجتِمَع	يِجتمَع		to meet (by prior agreement), meet with, to meet assemble, come together (intrans)
إجتَهَد	يِجتَهَد	8	to try hard, make an effort, do one's best
إحتاج	يِحتاج		to need, require
إحتَجّ	يِحتَجّ	9	to protest
إحتَدّ	يِحتَدّ	9	to become more acute
إحتِرَم	يِحتَرَم		to respect, treat with respect, esteem, honor
إحتَفَل	يِحتَفَل	8	to celebrate
إحتَقَر	يِحتَقَر	8	to despise, scorn, feel contempt for
إحتَكّ	يِحتَكّ	9	to rub up against, be in contact with
إحتَكَر	يِحتَكَر	8	to monopolize, gain exclusive control of, corner
إحتَلّ	يِحتَلّ	9	to occupy (military)
إحتَوى	يِحتوي	8	to comprise off, consist of, be made up of
إحمَرّ	يِحمَرّ	9	to blush, flush, turn red, redden
إختار	يِختار		to choose (usually abstract)
إختَرَع	يِختَرَع	8	to invent
إختَطَف	يَختَطَف	8	to take by force, to kidnap, abduct, hijack
إختَفى	يِختَفي	8	to disappear, vanish
إختَلّ	يِختَلّ	9	to become defective, develop a fault
إختَلَس	يِختَلَس	8	to embezzle, to steal
إختَلَط	يَختَلَط	8	to be mixed
إختَلَف	يِختَلَف	8	to differ, be different, to disagree
إختَنَق	يِختَنَق	8	to suffocate, be suffocated, to choke
إدَّعى	يِدَّعي		to allege, claim, accuse
إرتاح	يِرتاح		to rest
إرتَبَك	يِرتبَك	8	to become confused, get mixed up, get muddled, be embarrassed
إرتَخى	يِرتَخي	8	to relax (intrans)
إرتَدّ	يِرتَدّ	9	to withdraw, to become an apostate, renounce one's faith, lapse
إرتَسَم	يِرتَسَم	8	to be ordained (eg priest)
إرتَفَع	يِرتفَع	8	to rise, go up, ascend
إرتَكَب	يِرتَكَب	8	to commit, perpetrate
إرتَوى	يِرتوي	8	to quench one's thirst, to become saturated
إزدَهَر	يِزدَهَر		to flourish, bloom, prosper, thrive
إستأَجَر	يِستأَجَر	10	to hire, rent
إستأَصَل	يِستأَصَل	10	to uproot, annihilate, to remove (by surgery)
إستأَنَف	يِستأَنَف	10	to resume, recommence, appeal (legal)
إستاهَل	يِستاهَل	10	to deserve, warrant
إستَحسَن	يِستَحسَن	10	to approve of, consider appropriate
إستَحضَر	يِستَحضَر	10	to summon, conjure, invoke, call up (ask for the presence of)
إستَحَقّ	يِستحَقّ	10	to deserve, be worthy of
إستَحلى	يِستَحلي	10	to like, to find sweet/nice/beautiful
إستَحى	يِستحي	10	to be embarrased, be shy, be ashamed, be timid
إستَخدَم	يِستَخدَم	10	to use, make use of
إستَخرَج	يِستَخرَج	10	to extract, mine
إستَخَفّ	يِستخَفّ	10	to undervalue, underestimate, make light of, despise
إستَراح	يِستريح	10	to rest, sit down and rest
إستَرجَع	يِستَرجَع	10	to regain, take back, recover, ask for the return of
إستَرجى	يِستَرجي	10	to dare, have the courage to
إسترَيَّح	يِسترَيَّح	10	to rest, sit down to rest
إستَسلَم	يِستَسلَم	10	to submit, surrender, give up
إستَشار	يِستَشير	10	to consult, ask for advice
إستَشهَد	يِستَشهَد	10	to quote, to give one's life, die a martyr
إستَصعَب	يِستَصعَب	10	to find difficult, to have difficulty
إستَضاف	يَستَضيف	10	to invite, host as a guest
إستَطاع	يَستَطيع	10	to be able, be capable
إستَعار	يِستعير	10	to borrow (used only when the object is returned)
إستَعَدّ	يِستَعَدّ	10	to prepare oneself, stand by, be prepared
إستَعرَض	يِستَعرَض	10	to review
إستَعمَل	يِستَعمَل	10	to use, make use of, employ
إستَعوَق	يِستَعوَق	10	to think (something's) taking too long, to wonder why (something) is delayed/hasn't come back
إستَغرَب	يِستَغرَب	10	to be surprised, be astonished, find strange, be wierded out
إستَغفَر	يِستَغفَر	10	to apologise, ask for forgiveness
إستَغَلّ	يِستَغَلّ	10	to exploit, take advantage of
إستَغنَم	يِستَغنَم	10	to use, take advantage of
إستَغنى	يِستَغني	10	to be rich enough without, to do without, manage without, get along without
إستَفاد	يِستَفيد	10	to find useful, make good use of, find profitable, get something out of
إستَفَزّ	يِستَفَزّ	10	to provoke
إستَفقَد	يِستَفقَد	10	to miss (something/someone that was absent
إستَفهَم	يِستَفهَم	10	to enquire, want to know, want to understand
إستَقال	يَستَقيل	10	to resign
إستِقبَل	يِستَقبَل	10	to welcome, recieve (a person)
إستَقرَض	يِستَقرَض	10	to borrow
إستَلَزّ	يِستَلَزّ	10	to enjoy, find pleasant/nice
إستَلَم	يِستلَم	10	to recieve
إستَمَرّ	يِستَمَرّ	10	to continue, last, take (time), persevere, go on
إستَنتَج	يِستَنتَج	10	to conclude, infer, deduce
إستِنَد	يِستَنَد	10	to rely on, to use as an authority
إستَنّى	يِستَنّى		to wait
إستَهجَن	يِستَهجَن	10	to disapprove of, condemn, to be surprised, be astonished, be taken aback
إستَهزَئ	يِستَهزَئ	10	to mock, ridicule
إستَهوَن	يِستَهوَن	10	to undervalue, underrate, misjudge, make light of, disdain
إستَوحى	يِستَوحي	10	to be inspired by, borrow (an idea etc)
إستَورَد	يِستَورَد	10	to import
إستَوطَن	يِستَوطَن	10	to settle, settle down (intrans), to take up residence (seek a homeland)
إستَوعَب	يِستَوعَب	10	to take in, absorb, assimilate
إستَولى	يِستَولي	10	to sieze control of, take possession of
إستَوى	يِستوي	10	to ripen, become ripe, to cook (intrans), get cooked
إسمَرّ	يِسمَرّ	9	to tan, get a tan
إسوَدّ	يِسوَدّ	9	to be black, to turn black, blacken (intrans)
إشتاق	يِشتاق		to miss, long for, be homesick
إشتَبَه	يِشتبَه	8	to suspect
إشتَدّ	يِشتَدّ	9	to become stronger, intensify
إشتَرَك	يِشترَك	8	to participate, take part in, to share (in)
إشتَرى	يِشتري	8	to buy
إشتَغَل	يِشتغَل	8	to work
إشتكى	يِشتَكي	8	to complain
إشمَأَزّ	يِشمَأَزّ		to be disgusted, be revolted, be horrified
إصطاد	يِصطاد		to hunt
إصطَدَم	يِصطَدَم	8	to clash, collide, crash
إصطَفَل	يِصتَفَل	8	to cope, deal with, sort out
إصفَرّ	يِصفَرّ	9	to turn yellow (intrans)
إضطَرّ	يِضطَرّ	9	to be forced, be compelled, be obliged
إضطَهَد	يَضطَهَد		to persecute
إعتَبَر	يِعتَبَر	8	to regard, consider, esteem, respect
إعتَدى	يِعتَدي	8	to attack, assault, carry out a hostile act, commit an aggression, to trespass
إعتَرَف	يَعتَرَف	8	to confess, admit, recognize, acknowledge
إعتَزَر	يِعتَزَر	8	to apologize
إعتَقَد	يَعتَقَد	8	to believe, think, be of the opinion
إعتَمَد	يِعتَمَد	8	to depend, rely
إعتَنى	يِعتني	8	to take care of, look after, care for
إغتال	يِغتال		to assassinate
إغتَصَب	يِغتَصَب	8	to rape, violate, rob, usurp
إفتَخَر	يِفتَخَر	8	to be proud, boast, take pride in
إفتَرَس	يِفتَرَس	8	to devour
إفتَكَر	يِفتَكَر	8	to think
إقتَحَم	يَقتَحَم	8	to break in, to hack, hack into (computer), to storm
إقتَرَح	يِقترَح	8	to suggest, propose
إقتَنَع	يِقتَنَع	8	to be convinced, be persuaded
إكتَشَف	يِكتَشَف	8	to discover
إكتَفى	يِكتفي	8	to make do with, be content with, find sufficient
إلتَخَم	يِلتخَم	8	to be dumbfounded, get unnerved
إلتَزَم	يِلتزَم	8	to commit oneself, undertake, pledge, to abide by, comply with, observe
إلتَغى	يِلتَغي	8	to be cancelled, to be abolished, to be abrogated
إلتَفَت	يِلتفَت	8	to turn, turn around (intrans)
إلتَقى	يِلتقي	8	to meet, get together, meet with, to be present (be found), there are
إلتَهَب	يِلتهَب	8	to become inflamed (medical?)
إلتَوى	يِلتوي	8	to get twisted, get sprained
إمتِحَن	يِمتحَن		to examine, give an examination
إمتَنَع	يِمتنَع	8	to refrain, abstain
إنأَسَر	يِنأَسَر	7	to be taken prisoner
إنباع	يِنباع	7	to be sold
إنبَحّ	يِنبَحّ	7	to become hoarse, lose your voice
إنبَسَط	يِنبَسَط	7	to be pleased, be happy, be glad, to enjoy yourself
إنبَلّ	يِنبَلّ	7	to get wet, get damp
إنبَنى	يِنبَنى	7	to be built
إنتَبَه	يِنتِبَه	7	to pay attention, notice, watch out, be careful
إنتَحَر	يِنتحَر	7	to commit suicide
إنتَخَب	يِنتَخَب	7	to vote for, to elect
إنتَسى	يِنتَسى	7	to be forgotten
إنتَشَر	يِنتشَر	7	to spread (intrans), be published
إنتَصَر	يِنتَصَر	7	to be victorious, win (war)
إنتَظَر	يِنتَظَر	7	to wait, await
إنتَعَش	يِنتَعَش	7	to recover, revive, feel refreshed, feel invigorated
إنتَفَخ	يِنتفَخ	7	to inflate (intrans), become inflated
إنتَقَد	يِنتَقَد	7	to criticize, be critical
إنتَقَل	يِنتقَل	7	to move, move on, transfer, relocate (all intrans), be transferred
إنتَقَم	يِنتقَم	7	to take revenge, be avenged, avenge oneself
إنتَكَس	يِنتكَس	7	to relapse
إنتَلى	يِنتلي	7	to fill up (intrans), become full
إنتَمى	يِنتَمي	7	to belong, to be related
إنتَهَز	يِنتهَز	7	to make good use of, take advantage of, to sieze (an opportinity)
إنتَهى	يِنتهي	7	to end (intrans), finish (intrans), come to an end, be over, be up
إنجَبَر	يِنَجبَر	7	to be forced, be obliged, have to
إنجَذَب	يِنجَذَب	7	to be attracted
إنجّرّ	يِنجَرّ	7	to be dragged, be pulled along
إنجَرَح	يِنَجرَح	7	to get hurt, be wounded, get injured, be offended
إنجَرَف	يِنجَرَف	7	to be swept away, get carried away (also metaphorical)
إنجَنّ	يِنجَنّ	7	to go insane
إنحاز	يِنحاز	7	to take sides
إنحَرَف	يِنحَرَف	7	to deviate, turn aside, be led astray, go off the rails
إنحَرَق	يِنحرَق	7	to burn, get burned, be burned
إنحَشى	يِنحَشى	7	to be stuffed
إنحَكَم	يِنحَكَم	7	to be sentenced
إنحَكى	يِنحَكى	7	to be spoken, be told, be related, be expressed
إنحَلّ	يِنحَلّ	7	to be solved, to come untied, come unraveled
إنخَرَب	يِنَخرَب	7	to be destroyed, be ruined
إنخَفَض	يِنخَفَض	7	to drop, decrease, be reduced (intrans)
إنخَمَد	يِنخَمَد	7	to calm down (intrans), to subside, die down
إندَبّ	يِندَبّ	7	to fall over, fall down
إندَعَك	يِندَعَك	7	to have a hard time, go through a lot
إندَمَج	يِندَمَج	7	to fit in, integrate, become part of, be absorbed
إندَهَس	يِنَدهَس	7	to get run over, to get knocked down
إندَهَش	يِنَدهَش	7	to be amazed
إندَهَك	يِنَدهَك	7	to get run over, get knocked down (by a vehicle)
إندَوَش	يِنَدوَش	7	to become bewildered, get flustered
إنذاع	يِنذاع	7	to be broadcast
إنزار	يِنزار	7	to be visited, recieve a visit
إنزَرَع	يِنزَرَع	7	to be sown (seed, land, etc)
إنزَلَق	يِنزَلَق	7	to slip, slide, glide
إنسَحَب	يِنسَحَب	7	to retreat, withdraw
إنسَدّ	يِنسَدّ	7	to be blocked, get blocked up
إنسَرَق	يِنَسرَق	7	to be stolen, get stolen, be robbed
إنسَطَل	يِنَسطَل	7	to become confused, become dazed / groggy (from shock, alcohol, etc)
إنشاف	يِنشاف	7	to be seen, be visible
إنشَدّ	يِنشَدّ	7	to be tightened, pulled tight, become taut
إنشَعَط	يِنشَعَط	7	to burn (intrans), get burned
إنشَغَل	يِنَشغَل	7	to be busy, be occupied
إنشَقّ	يِنشَقّ	7	to be split
إنصَمَط	يِنصَمَط	7	to burn oneself, get burned
إنضَرَب	يِنضَرَب	7	to get hit, get beated up, get knocked, get dented
إنضَمّ	يِنضَمّ	7	to join, become a part of
إنطاق	يِنطاق	7	to be bearable
إنطَخ	يِنطَخ	7	to get shot
إنطَعَج	يِنَطعَج	7	to bend (intrans), become bent
إنطَفى	يِنطَفي	7	to go out, be extinguished
إنطَوى	يِنَطوي	7	to fold (intrans), become folded
إنظَلَم	يِنظَلَم	7	to be oppressed, be treated unjustly
إنعَدّ	يِنعَدّ	7	to be counted, be calculated, to be considered, be reckoned, to count as
إنعَدى	يِنَعدي	7	to become infected, catch (an illness)
إنعَرَض	يِنعَرَض	7	to be shown, be presented, be exhibited
إنعَكَس	يِنعَكَس	7	to be reflected
إنعَمَل	يِنعَمَل	7	to be done, get done
إنعَمى	يِنَعمي	7	to go blind, be dazzled, be blinded
إنعَوَر	يِنَعوَر	7	to lose an eye, become blind in one eye
إنغَسَل	يِنَغسَل	7	to be washed / laundered
إنغَصَب	يِنَغصَب	7	to be forced, to be raped
إنغَلى	يِنغَلى	7	to be boiled
إنفَتَح	يِنَفتَح	7	to open (intrans), be opened
إنفَحَص	يِنفَحَص	7	to be examined
إنفَرَد	يِبفَرَد	7	to be unique, be alone, be seperate, be isolated
إنفَرَط	يِنفَرَط	7	to fall apart, come to pieces, to unravel, fray
إنفَصَل	يِنفَصَل	7	to part, to be separated
إنفَطَم	يِنَفطَم	7	to be weaned
إنفَعَص	يِنَفعَص	7	to get squashed, get crushed, get run over
إنفَعَل	يِنفَعَل	7	to be excited, be agitated
إنفَكّ	يِنفَكّ	7	to come undone, come untied, come apart, to come loose, to get dislocated
إنقال	يِنقال	7	to be said
إنقَبَل	يِنَقبَل	7	to get accepted, be recieved
إنقَتَل	يِنقَتَل	7	to be killed
إنقَرى	يِنقَرى	7	to be read, be legible
إنقَطَع	يِنَقطَع	7	to break (intrans), to be interrupted, get disconnected, to detatch from, cut oneself off from, stay away from, cut ties with
إنقَلَب	يِنَقلَب	7	to overturn, capsize, turn inside out
إنقَلَع	يِنَقلَع	7	to get pulled out, get torn, get uprooted
إنقَهَر	يِنَقهَر	7	to be hurt, be offended, get upset
إنكَبّ	يِنكَبّ	7	to spill (intrans), be spilt, get spilt
إنكَسَر	ينَكسَر	7	to break (intrans), pile up (intrans), create a backlog
إنكَشَف	يِنكَشَف	7	to get discovered, be revealed
إنكَمَش	يِنكَمَش	7	to shrink into oneself, become withdrawn
إنمَحى	يِنَمحي	7	to get rubbed out, be erased
إنمَسَك	يِنمَسَك	7	to get caught
إنهار	يِنهار	7	to collapse
إنهَدَم	يِنَهدَم	7	to be destroyed, get demolished
إنهَزّ	يِنهَزّ	7	to shake (intrans), tremble, quiver, quake
إهتَرى	يِهتري	8	to wear out (intrans), get worn out
إهتَزّ	يِهتَزّ	9	to be shaken, be shocked
إهتَمّ	يِهتَمّ	9	to take an interest in, to be interested in, to care, consider, pay attention to
احْمَرّ	يحْمَرّ		to turn red
ازْعَل	يزْعِل		to upset
اسْتَعْمَل	يسْتَعْمِل		to use
اِسْتَلَم	يِسْتْلِم		to receive
اْسْتَنَّى	يِسْتَنَّى		to wait
اشْتَغَل	يشْتْغِل		to work
اعْتَمَد	يعْتَمِد		to rely on
اِنْطِفا	ينْطِفا		to be put out
انْفَتاح	ينْفْتاح		to open
بات	يبات	1	to spend the night
باح	يبوح	1	to be revealed, to reveal, divulge
باخ	يبوخ	1	to fade (lose color)
بادَر	يبادَر	3	to take an/the initiative
بارَك	يبارَك	3	to bless, congratulate
باس	يبوس	1	to kiss
باض	يبيض	1	to lay (an egg)
باع	يبيع	1	to sell
بالَغ	يبالَغ	3	to exaggerate
بان	يبان	1	to appear
بَثّ	يبَثّ	1	to broadcast
بَجَّل	يبَجَّل	2	to treat with respect, to praise
بَحّ	يبَحّ	1	to rinse
بَحبَش	يبَحبَش	1	to search, rummage
بَحَث	يِبحَث	1	to research, study
بَحَز	يِبحَز	1	to move over
بَحَّز	يبَحَّز	2	to move up, move over, scoot over
بَحَش	يِبحَش	1	to dig, hoe, to search
بَحلَق	يبَحلَق	1	to stare, to gaze
بَخّ	يبوخّ	1	to spray
بَخبَخ	يبَخبَخ	1	to drizzle
بَخَّر	يبَخَّر	2	to cense, incense
بخَلّى	يِتخَلّى		to relinquish, give up, let go
بَدَع	يِبدَع	1	to excel, be outstanding, to invent, create, improvise
بَدَّل	يبَدَّل	2	to change, exchange
بِدي	يِبدى	1	to begin, start
بِدِي	يبْدَى		to begin
بَذَل	يِبذَل	1	to give generously, sacrifice, offer
بَربَر	يبَربَر	[4]	to mutter, jabber
بَرجَم	يبَرجَم		to coo
بَرَد	يُبرُد	1	to become cold, to catch cold, to file
بَردَخ	يبَردَخ		to polish, make smooth
بَرَّر	يبَرَّر	2	to justify
بَرَز	يُبرُز	1	to protrude, stick out, be prominent, be conspicuous
بَرَش	يُبرُش	1	to grate
بَرطَل	يبَرطَل		to bribe
بَرعَم	يبرغم		to sprout, to bud
بَرَق	يبرَق	1	to flash lightning
بَرَم	يُبرُم	1	to twist, twine (rope, thread), to roam, to chatter
بَرمَج	يبَرمَج		to program, to plan
بَرهَن	يبَرهَن		to prove
بَروَز	يبَروَز		to frame
بَرى	يِبري	1	to sharpen (a pencil)
بَرّى	يبَرّي	2	to acquit, declare innocent
بَزَّر	يبَزَّر	2	to waste, to scatter seeds, to beget (a large number of) children
بَزَق	يُبزُق	1	to spit
بَزَّق	يبَزَّق	2	to spit repeatedly
بَسّ	يبَسّ	1	to knead (dough)
بَسَط	يُبْسُط		to spread out, to extend
بَسَّط	يبسَّط	2	to simplify
بَشَّر	يبَشَّر	2	to preach
بَشَّع	يبَشَّع	2	to make ugly, to disfigure
بَشَّم	يبَشَّم	2	to rivet, affix with a stud
بَصبَص	يبَصبَص	[4]	to peep, size up, examine, check out, watch, spy, ogle
بَصَم	يُبصُم	1	to be fingerprinted, to sign with a fingerprint
بَصَّم	يبَصَّم	2	to fingerprint, take someone's fingerprints
بَطّ	يبُطّ	1	to stab, lance
بَطَّل	يبَطَّل	2	to stop, leave off, quit
بَطَّن	يبَطَّن	2	to line
بَعبَش	يبَعبَش		to search, poke around, rummage through
بَعَت	يِبعَت	1	to send
بَعتَر	يبَعتَر		to scatter
بَعزَق	يبَعزَق		to waste, dissipate
بَعَص	يِبعَص	1	to let (someone) down, to cause unpleasantness or disappointment
بَقَّع	يبَقَّع	2	to stain
بَقى	يِبقى	1	to remain, stay
بِقي	يِبقى	1	to remain, stay
بِقِي	يبْقَى		to remain
بَكى	يِبكي	1	to cry
بِكي	يِبكي	1	to cry
بَلّ	يبَلّ	1	to wet, moisten
بَلَّش	يبَلَّش	2	to begin
بَلّش	يبَلَّش		to begin
بَلَّط	يبَلَّط	2	to tile, to pave
بَلَع	يِبلَع	1	to swallow
بَلَغ	يُبلُغ	1	to reach, attain
بَلَّغ	يبَلَّغ	2	to announce, report
بَلَف	يِبلَف	1	to bluff, fool, trick
بَنَج	يِبنَج	1	to be taken aback, dumbfounded, amazed
بَنَّج	يبَنَّج	2	to anaesthetise, administer an anasthetic
بَنشَر	يبنشر		to have a puncture (from english)
بَنى	يِبني	1	to build
بَنَى	يبْني		to build
بَهدَل	يبَهدَل		to reprimand, tell off, shout at, to humiliate, treat with contempt
بَهَّر	يبَهَّر	2	to season, spice
بوبَز	يبوبَز		to bend over, bow, bow down
بَوَّز	يبَوَّز	2	to pout, to sulk
بَوَّز	يبَوَّز	2	to sharpen to a point
بَوَّس	يبَوَّس	2	to kiss repeatedly
بَوَّل	يبَوَّل	2	to urinate
بَيَّت	يبَيَّت	2	to leave overnight, to put someone up for the night
بَيَّض	يبَيَّض	2	to bleach, whiten, to make a fair copy
بَيَّن	يبَيَّن	2	to reveal, show, demonstrate, appear, be visible
تآنَس	يِتآنَس	6	to get together, spend time together (provide each other with company)
تأَثَّر	يِتأَثَّر	5	to be influenced, be effected, be impressed, be touched
تأَخَّر	يِأَخَّر	5	to be late
تأَزَّم	يِتأَزَّك	5	to become critical, come to a head, reach a crisis
تأَسَّف	يِتأَسَّف	5	to be sorry
تأَفـأَف	يِتأَفأَف		to sigh, say 'oof
تأَكَّد	يِتأَكَّد	5	to be confirmed, turn out to be true / right, to be sure, be convinced, make sure
تأَلَّم	يِتأَلَّم	5	to suffer, be in pain
تأَمَّر	يِتأَمَّر	5	to lord over, order about, behave imperiously
تأَمَّل	يِتأَمَّل	5	to hope, to contemplate, meditate, consider, reflect upon
تَئتَئ	يتَئتَئ		to stutter, stammer
تاب	يتوب	1	to repent, mend one's ways
تابَع	يتابَع	3	to follow, to continue
تاجَر	يتاجَر	3	to trade, deal, do business
تباخَل	يِتلباخَل	6	to be stingy
تبادَل	يِتبادَل	6	to exchange, substitute, change, be mutual
تباوَس	يِتباوَس	6	to kiss each other, exchange kisses
تبَحبَح	يِتبَحبَح		to live a life of luxury
تبَخَّر	يِتبَخَّر	5	to evaporate
تبَدَّل	يِتبَدَّل	5	to be replaced
تبَرطَل	يِتبَرطَل		to accept a bribe, be bribed
تبَرَّع	يِتبَرَّع	5	to donate, contribute, to volunteer
تبَرّى	يِتبَرّى	5	to be acquitted, be declared innocent, to refuse to accept responsibility, wash one's hands of
تبَضَّع	يِتبَضَّع	5	to go shopping, buy goods
تبَطَّح	يِتبَطَّح	5	to lie down flat, lie on one's stomach
تَبَع	يِتبَع	1	to follow, track, trail, pursue, to depend on, be a question of, to follow, stick by
تَبَّل	يتَبَّل	2	to season, to spice (بَهَّر more common)
تبَنّى	يِتبَنّى	5	to adopt
تبَهدَل	يِتبَهدَل		to be humiliated, be insulted, be despised
تبَيَّن	يِتبَيَّن	5	to emerge, become clear, become obvious
تتأَلَّم	يِتتأَلَّم		to get blunt
تتاكَل	يِتّاكَل	6	to be eaten, be edible
تتاوَب	يِتتاوَب	6	to yawn
تجادَل	يِتجادَل	6	to argue with each other
تجاهَل	يِتجاهَل	6	to ignore, disregard, refuse to acknowledge, give the cold shoulder
تجاوَز	يِتجاوَز	6	to go beyond, overstep, overtake
تجَبَّد	يِتجَبَّد	5	to stretch, stretch oneself
تجَدَّد	يِتجَدَّد	5	to be renewed
تجَسَّس	يِتجَسَّس	5	to spy
تجَعلَك	يِتجَعلَك		to wrinkle, crease
تجَمَّع	يِتجَمَّع	5	to congregate, gather together, assemble
تجَنَّب	يِتجَنَّب	5	to avoid, keep away from
تجَنَّد	يِتجَنَّد	5	to enlist, be conscripted, be drafted
تجَوَّز	يِتجَوَّز	5	to get married, to marry
تجَوَّل	يِتجَوَّل	5	to tour walk/travel around, roam, wander
تحابَب	يِتحابَب	6	to love each other
تحانَق	يِتحانَق	6	to quarrel, have a fight, strangle each other
تحَدَّث	يِتحَدَّث	5	to talk, chat, carry on a conversation
تَحَدَّث	يتحَدَّث		to converse, to chat, to talk
تحَدّى	يِتحَدّى	5	to provoke, to challenge
تحَرَّر	يِتحَرَّر	5	to free oneself, mecome free
تحَرَّك	يِتحَرَّك	5	to move (intrans)
تحَركَش	يِتحَركَش		to provoke, annoy, bother, bug, to poke, prod
تحَسَّر	يِتحَسَّر	5	to feel nostalgia, to sigh for, sigh over, lament
تحَسَّس	يِتحَسَّس	5	to grope (yo way in the dark)
تحَسَّن	يِتحَسَّن	5	to improve (intrans)
تحَطَّم	يِتحَطَّم	5	to get smashed up, break up, fall apart
تحَفَّظ	يِتحَفَّظ	5	to be wary, be cautious, to have reservations
تحَقَّق	يِتحَقَّق	5	to come true, be shown to be true, be proved true, to verify, confirm, make sure, check
تحَكَّم	يِتحَكَّم	5	to be treated, to control
تحَمَّر	يِتحَمَّر	5	to become red, to be well-done (meat), to put on lipstick
تحَمَّس	يِتحَمَّس	5	to get enthusiastic, become excited
تحَمَّل	يِتحَمَّل	5	to bear, stand
تحَمَّم	يِتحَمَّم	5	to bathe (intrans)
تحَنّى	يِتحَنّى	5	to henna one's hair, to decorate oneself with henna
تحَوَّل	يِتحَوَّل	5	to become, turn into, be transferred
تحَيَّر	يِتحَيَّر	5	to be/become embarrassed, to be at a loss, have no idea
تحَيَّز	يِتحَيَّز	5	to side with, favor, take sides
تخاصَم	يِتخاصَم	6	to be in conflict with each other, be rivals
تخَبّى	يِتخَبّى	5	to hide (intrans), hide oneself
تخَربَط	يِتخَربَط		to become confused, get mixed up
تخَرَّج	يِتخَرَّج	5	to graduate
تخَرَّف	يِتخَرَّف	5	to talk to each other, chat, tell each other stories
تخَصَّص	يِتخَصَّص	5	to specialize
تخَلخَل	يِتخَلخَل		to be shaky, be wobbly
تخَلَّص	يِتخَلَّص	5	to get rid of, rid oneself, free oneself
تخَوَّت	يِتخَوَّف	5	to be fearful, be apprehensive, be scared, be afraid
تخَوَّت	يِتخَوَّت	5	to fool around, horse around, joke around
تخَيَّل	يِتخَيَّل	5	to imagine, fancy
تدارى	يِتدارى	6	to protect oneself, take selter
تدافَش	يِتدافَش	6	to push one another, jostle one another
تدايَق	يِتدايَق	6	to be disturbed, be bothered, be troubled, get irritated, get upset, get annoyed
تدايَن	يِتدايَن	6	to borrow (money), get into debt
تدَبَّر	يِتدَبَّر	5	to sort itself out, be taken care of
تدَخرَج	يِتدَخرَج		to roll down, roll downhill (intrans)
تدَخَّل	يِتدَخَّل	5	to interfere, meddle
تدَرَّع	يِتدَرَّع	5	to burp (intrans)
تدَروَخ	يِتدَروَخ		to stagger, totter
تدَشّى	يِتدَشّى	5	to belch
تدَعتَر	يِتدَعتَر		to trip, trip up (intrans)
تدَفّى	يِتدَفّى	5	to warm up (intrans), get warm, warm oneself
تدَلَّع	يِتدَلَّع	5	to become spoilt, to behave like a spoilt child, to be demanding
تدَلَّل	يِتدَلَّل	5	to demand attention, indulge oneself
تدَهوَر	يِتدَهوَر		to roll down, roll downhill, to deteriorate
تدَوَّش	يِتدَوَّش	5	to shower, take a shower
تدَيَّن	يِتدَيَّن	5	to be religious, be observant
تْذَكَّر	يتْذَكَّر		to recall
تذَمَّر	يِتذَمَّر	5	to complain
ترَئَّس	يِترَئَّس	5	to head, be in charge, to chair
تراجَع	يِتراجَع	6	to retreat, withdraw, to drop, change one's mind about, revoke, go back on
تراخى	يِتراخى	6	to get sloppy, become lax
تراقَب	يِتراقَب	6	to be under supervision, be censored
تراهَن	يِتراهَن	6	to bet, wager
ترَبَّع	يِترَبَّع	5	to sit cross-legged
ترَبّى	يِترَبّى	5	to grow up, be brought up, be educated, be raised
تْرَبّى/رِبي	يتْرَبَّى/يرْبي		to be brought up
تَرجَم	يتَرجَم		to translate
تَرْجَم	يتَرْجِم		to translate
ترَجّى	يِترَجّى	5	to look forward to, hopefor, ask for, to beg, plead, implore
ترَدَّد	يِترَدَّد	5	to hesitate, to visit often, pay repeated visits
ترَسَّب	يِترَسَّب	5	to settle, accumulate, build up (all intrans)
ترَصَّد	يِترَصَّد	5	to lie in wait, set an ambush
ترَغرَغ	يِترَغرَغ		to gargle
ترَقّى	يِترَقّى	5	to be promoted, recieve a promotion, climb the social ladder
تَرَك	يِترَك	1	to leave, stop
ترَمَّل	يِترَمَّل	5	to be widowed
ترَنَّح	يِترَنَّح	5	to stagger
ترَيَّح	يِترَيَّح	5	to relax, rest, to feel relieved, be relieved (of worry, problems)
تزاعَل	يِتزعَل	6	to be angry with each other
تزَحلَق	يِتزَخلَق		to slide, slip
تزَعزَع	يِتزَعزَع		to be shaken, be undermined
تزَكَّر	يِتزَكَّر	5	to remember, recall
تزَلَّج	يِتزَلَّج	5	to slide along, to skate, to ski
تزَوَّج	يِتزَوَّج	5	to get married, marry (intrans)
تسابَق	يِتسابَق	6	to compete, have a race
تساعَد	يِتساعَد	6	to help one another
تساهَل	يِتساهَل	6	to be lenient, be flexible, be forebearing
تسَبَّب	يِتسَبَّب	5	to be caused, to result, to earn a small amount of money, make a few bucks
تسَحسَل	يتسَحسَل		to slide (down a slide)
تسَخَّن	يِتسَخَّن	5	to heat up (intrans), be heated
تسَدَّق	يِتسَدَّق	5	to be credible, be believable
تسَرَّب	يِتسَرَّب	5	to run out, flow off, to sneak out
تسَرَّح	يِتسَرَّح	5	to get demobilized
تسَرَّع	يِتسَرَّع	5	to hurry, be in a hurry, go too fast, be too hasty
تسَطَّح	يِتسَطَّح	5	to lie down
تسَكَّر	يِتسَكَّر	5	to close (intrans)
تسَلسَل	يِتسَلسَل		to be continuous, be in order, form a series
تسَلَّط	يِتسَلَّط	5	to take control of, take over, sieze control of, dominate
تسَلّى	يِتسَلّى	5	to pass the time, have fun, have a good time, amuse/entertain/enjoy oneself
تسَمَّم	يِتسَمَّم	5	to get poisoned, get food poisoning
تسَهَّل	يِتسَهَّل	5	to depart, leave, go
تسَهَّل	يِتسَهَّل	5	to become easy, to set out, go
تسَوَّق	يِتسَوَّق	5	to shop, go shopping
تشائَم	يِتشائَم	6	to be pessimistic, expect the worst, to be superstitious, believe something brings bad luck
تشابَه	يِتشابَه	6	to be alike, resemble each other
تشارَط	يِتشارَط	6	to impose conditions on each other, to bet each other
تشاطَر	يِتشاطَر	6	to be a wise guy, be a know it all
تشاوَر	يِتشاوَر	6	to consult, deliberate
تشَبَّع	يِتشَبَّع	5	to become saturated, become full to capacity
تشَتَّت	يِتشَتَّت	5	to disperse, scatter (intrans)
تشَجَّع	يِتشَجَّع	5	to be encouraged, take heart
تشَرَّف	يِتشَرَّف	5	to be honored
تشَرَق	يِتشَردَق		to swallow the wrong way
تشَعَّب	يِتشَعَّب	5	to branch, form, to branch out, branch off
تشَعبَط	يِتشَعبَط		to climb
تشَكّى	يِتشَكّى	5	to complain
تشَنَّج	يِتشَنَّج	5	to be in spasm, have a cramp
تصادَف	يِتصادَف	6	to meet by chance, run into each other, come across each other
تصادَم	يِتصادَم	6	to crash (intrans), crash into each other, collide
تصالَح	يِتصالَح	6	to make peace with one another, reconcile, make up
تصاوَب	يِتصاوَب	6	to get wounded
تصايَح	يِتصايَح	6	to shout/yell at one another
تصَرَّف	يِتصَرَّف	5	to behave, to behave well, to cope, manage
تصَفَّح	يِتصَفَّح	5	to leaf through, flick through (book etc)
تصَلَّب	يِتصَلَّب	5	to harden, become hard
تصَوَّر	يِتصَوَّر	5	to imagine, to get photographed
تصَيَّد	يِتصَيَّد	5	to hunt, to fish
تضارَب	يِتضارَب	6	to hit / strike / slap one another, to run / crash into one another
تضامَن	يِتضامَن	6	to show solidarity
تضَخَّم	يِتضَخَّم	5	to expand, dilate, inflate, swell up
تضَرَّر	يِتضَرَّر	5	to sustain damage, get damaged
تطَبَّش	يِتطَبَّش	5	to crash into each other, collide
تطَرَّف	يِتطَرَّف	5	to become an extremist, be extreme, go to extremes, hold radical views
تطَلَّع	يِتطَلَّع	5	to look, look at
تطَمَّن	يِتطَمَّن	5	to calm down, have one's fears allayed, be reassured, reassure oneself, have one's mind put at rest
تطَوَّر	يِتطَوَّر	5	to develop (intrans)
تطوطَح	يِتطوتَح		to sway, swagger
تطَوَّع	يِتطَوَّع	5	to volunteer
تظاهَر	يِتظاهَر	6	to demonstrate, protest, to feign, pretend
تعابَط	يِتعابَط	6	to behave stupidly, act like an idiot, to hug each other
تعادَل	يِتعادَل	6	to be equal [to], to draw (sports/games)
تعاطى	يِتعَطى	4	to take (medicine, drug)
تعاقَب	يِتعاقَب	6	to be punished (by the legal system)
تعالَج	يِتعالَج	6	to be treated, recieve treatment
تعامَل	يِتعامَل	6	to work with, to treat, deal with, relate to
تعاوَن	يِتعاوَن	6	to cooperate, help one another
تعايَش	يِتعايَش	6	to coexist
تِعَب	يِتعَب	1	to tire, become tired
تِعِب	يتْعَب		to get tired
تعَجَّب	يِتعَجَّب	5	to be surprised, be astonished, be amazed, marvel at, wonder
تعَدَّد	يِتعَدَّد	5	to multiply, proliferate, become numerous
تَعَدّى	يِتعَدّى		to cross, go beyond, overstep, encroach upon, to overtake
تعَربَش	يِتعَربَش		to climb
تعَرَّض	يِتعَرَّض	5	to risk, be exposed to, to pester, harass
تعَرَّف	يِتعَرَّف	5	to get to know, make acquaintance of, to introduce oneself
تعَزَّز	يتعزز	5	to be strengthened, become stronger
تعَشّى	يِتعَشّى	5	to dine, to sup, to have dinner
تعَصَّب	يِتعَصَّب	5	to become extremist, become a fanatic
تعَطَّر	يِتعَطَّر	5	to put on perfume, weat a scent
تعَطَّش	يِتعَطَّش	5	to thirst for, long for
تعَطَّل	يِتعَطَّل	5	to become unemployed, be out of work, to stop working, to stall (engine)
تعَكَّز	يِتعَكَّز	5	to lean, support oneself
تعَلَّق	يِتعَلَّق	5	to cling, hold on to, clutch at, to depend, to become emotionally attached
تعَلَّم	يِتعَلَّم	5	to learn
تعَمَّد	يِتعّمَّد	5	to be baptized
تعَمَّق	يِتعَمَّق	5	to go into (somthing) deeply
تعَهَّد	يِتعَهَّد	5	to commit oneself, pledge, undertake, promise
تعَوَّد	يِتعَوَّد	5	to get used to, become accustomed to
تعَوَّق	يِتعَوَّق	5	to be delayed, be detained, get held up
تعَيَّن	يِتعَيَّن	5	to be appointed, get nominated
تغازَل	يِتغازَل	6	to flirt with each other
تغاشَم	يِتغاشَم	6	to pretend to be inexperienced/ignorant
تغامَز	يِتغامَ	6	to exchange (knowing) winks, wink at one another
تغَدّى	يِتغَدّى	5	to have lunch
تغَرَّق	يِتغَرَّق	5	to get soaking wet
تغَسَّل	يِتغَسَّل	5	to wash oneself, to bathe, take a bathshower
تغَشَّم	يِتغَشَّم	5	to fail to recognize
تغَلَّب	يِتغَلَّب	5	to find difficult, have a hard time, to overcome
تغَيَّر	يِتغَيَّر	5	to change (intrans)
تَفّ	يتَفّ	1	to spit, to splutter, spray (others) with saliva
تفاجَئ	يِتفاجَئ	6	to be surprised, be taken by surprise
تفارَق	يِتفارَق	6	to part, split up
تفاهَم	يِتفاهَم	6	to understand one another, to reach an understanding
تفاوَض	يِتفاوَض	6	to negotiate
تَفتَف	يتَفتَف	[4]	to sputter, splutter
تفَتفَت	يتفَتفَت		to crumble
تفَرَّج	يِتفَرَّج	5	to watch, look at, observe (nature, TV, pictures, etc)
تفَرَّغ	يِتفَرَّغ	5	to free oneself, make time for, to be emptied out
تفَرَّق	يِتفَرَّق	5	to scatter, disperse, split up
تفَركَش	يِتفَركَش		to trip (up) (intrans), run into, bang into
تفَرهَد	يِتفَرهَد		to get out of constricting clothes, to change into something more comfortable
تفَشفَش	يِتفَشفَش		to vent one's emotions, take one's emotions out on someone else
تفَشّى	يِتفَشّى		to spread (intrans)
تفَضَّل	يِتفَضَّل	5	to be so kind (as to)
تفَعفَل	يِتفَعفَل		to convulse, have convulsions, flap around
تفَكفَك	يتفَكفَك		to become untied, come undone, fall apart
تفَلسَف	يِتفَلسَف		to philosophize, be pedantic, split hairs
تفَوَّق	يِتفَوَّق	5	to excell
تقابَل	يِتقابَل	6	to meet (intrans), meet with, to be recieved by
تقاتَل	يِتقاتَل	6	to hit one another, to fight
تقارَب	يِتقارَب	6	to become close, draw closer to one another
تْقارَب	يتْقارَب		to approach
تقاسَم	يِتقاسَم	6	to share, divide up
تقاصَص	يِتقاصَص	6	to be punished (home/scool)
تقاعَد	يِتقاعَد	6	to retire (from work)
تَقتَق	يتَقتَق	[4]	to tick
تقَدَّم	يِتقَدَّم	5	to move forward, advance, progress
تْقَدَّم	يتْقَدَّم		to advance
تقَشَّف	يِتقَشَّف	5	to be an ascetic, lead an ascetic life
تَقَّل	يتَقَّل	2	to make heavy, cause to be heavy
تقَلَّب	يِتقَلَّب	5	to turn over repeatedly (intrans), to fluctuate, be changeable, be unpredictable
تقَلَّص	يِتقَلَّص	5	to shrink, contract, get smaller
تقَوّى	يِتقَوّى		to get stronger
تَكّ	يتُكّ	1	to shake, shake off, shake out, fall out (hair), be shed (hair)
تكاتَب	يِتكاتَب	6	to correspond, write to each other
تكاسَل	يِتكاسَل	6	to be lazy, be idle, be too lazy to (do something)
تكَبَّر	يِتكَبَّر	5	to get bigger, to boast
تكَتَّف	يِتكَتَّف	5	to fold one's arms
تكَرَّر	يِتكَرَّر	5	to recur, happen again, be repeated
تكَرسَح	يِتكَرسَح		to become disabled, be left disabled
تكَرفَت	يِتكَرفَت		to fall and roll over
تكَسلَن	يِتكَسلَن		to be lazy, be idle, be too lazy to (do something) 2
تكَلَّم	يِتكَلَّم	5	to speak (more formal)
تكَهرَب	يِتكَهرَب		to get electrocuted
تكَوَّر	يِتكَوَّر	5	to become round, become spherical, to curl up
تكَوَّن	يِتكَوَّن	5	to pile up, accumulate
تكَيَّف	يِتكَيَّف	5	to adjust, adapt oneself
تلاعَب	يِتلاعَب	6	to cheat, get up to funny business (esp. prices)
تلاقى	يِتلاقى		to meet each other, run into each other
تلَبَّك	يِتلَبَّك	5	to become disorganized, get confused, be at a loss, not know what to do/think
تلَحلَح	يِتلَحلَح		to flourish, succeed
تلَخَّص	يِتلَخَّص	5	to be summed up
تلَفَّت	يِتلَفَّت	5	to turn around, swing round, look round
تَلْفَن	يتَلْفِن		to phone
تلَقَّح	يِتلَقَّح	5	to lie down
تلَقلَق	يِتلَقلَق		to wobble
تلَقّى	يِتلَقّى		to get, recieve
تلَوّى	يِتلَوّى		to be doubled up, to writhe
تَلى	يَتلو	1	to read aloud, recite
تَمّ	يتَمّ	1	to stay, remain, be left, to continue, go on
تَمّ	يتِمّ	1	to be finished, complete, to take place, be carried out, get done
تمالَك	يِتمالَك	6	to restrain oneself, hold oneself back
تمايَع	يِتمايَع	6	to liquify, melt, behave flirtatiously, become flabby
تمَتَّع	يِتمَتَّع	5	to enjoy
تمَدَّد	يِتمَدَّد	5	to lie down (extend oneself),
تمَرجَح	يِتمَرجَح		to swing (intrans)
تمَرَّد	يِتمَرَّد	5	to rebel, revolt
تمَرَّن	يِتمَرَّن	5	to practise, excersize, train oneself
تمَسخَر	يِتمَسخَر		to laugh at, ridicule, make fun of
تمَسَّك	يِتمَسَّك	5	to hold, cling, stick to
تمَشَّط	يِتمَشَّط	5	to comb one's hair
تمَكَّن	يِتمَكَّن	5	to be able, be capable
تمَلَّق	يِتمَلَّق	5	to flatter, to suck up to, brown nose
تمَلَّك	يِتمَلَّك	5	to take possession of, sieze, usurp, appropriate
تَمَّم	يتَمَّم	2	to complete, carry out, execute, accomplish
تمَنّى	يِتمَنّى	5	to wish, hope
تمَوَّن	يِتمَوَّن	5	to stock up with provisions/supplies
تمَيَّز	يِتمَيَّز	5	to distinguish oneself, stand out, be special, be different
تنازَل	يِتنازَل	6	to give up, concede, drop
تناسَب	يِتناسَب	6	to be(come) related by marriage
تناسى	يِتناسى		to pretend to forget
تناطَح	يِتناطَح	6	to butt each other
تناقَض	يِتناقَض	6	to contradict one another, be contradictory
تناوَب	يِتناوَب	6	to take turns, spell each other, work in shifts
تناوَل	يِتناوَل	6	to go to communion (christianity)
تنَبَّئ	يِنَبَّ	5	to prophesy, fortell
تنَجَّس	يِتنَجَّس	5	to become ritually impure (eg by touching a dog)
تنَحنَح	يِتنَحنَح		to clear one's throat (to express disagreement or sarcasm), to make one's presence felt
تنَشَّف	يِتنَشَّف	5	to dry
تنَفَّذ	يِتنَفَّذ	5	to be implemented, be executed, be carried out, be kept
تنَفَّس	يِتنَفَّس	5	to breathe
تنَكَّر	يِتنَكَّر	5	to be estranged, be alienated, to dress up, disguise yourself
تَنى	يِتني	1	to fold
تهابَل	يِتهابَل	6	to pretend to be stupid, to act stupidly
تهاوَن	يِتهاوَن	6	to treat lightly, attach little importance to
تهَرَّب	يِتهَرَّب	5	to run away, escape, avoid, evade, shirk
تهَزَّر	يِتهَوَّر	5	to endanger oneself, take risks, behave recklessly
تهَوّى	يِتهَوّى	5	to get aired out
تْهَيَّأ	يِتْهَيَّأ	5	to be drawn up
تهَيَّج	يِتهَيَّج	5	to be in a ferment, be agitated, to be stormy, be rough
توافَق	يِتوافَق	6	to fit in, tally, make sense with
توانى	يِتوانى		to take one's time (over somthing), to slack off
توَتَّر	يِتوَتَّر	5	to tense up, become tense
تَوَّج	يتَوَّج	2	to crown
توَجَّع	يِتوَجَّع	5	to suffer pain, be in pain
توَجَّه	يِتوَجَّه	5	to turn towards, to apply to, address, speak to
توَحَّل	يِتوَحَّل	5	to get muddy, get covered in mud
توَرَّت	يِتوَرَّت	5	to inherit, be inherited
تَوَرَّط	يِوَرَّط		to get mixed up (in), get into trouble
توَرَّم	يِتوَرَّم	5	to swell (intrans), swell up
توَزَّع	يِتوَزَّع	5	to be divided, be distributed
توَسَّخ	يِتوَسَّخ	5	to get dirty, become soiled
توَسَّع	يِتوَسَّع	5	to expand, extend, spread, spread out (intrans)
توَشوَش	يتوَشوَش		to whisper together, talk in whispers
توَصَّل	يِتوَصَّل	5	to arrive at, reach, attain, to achieve
توَضَّح	يِتوَضَّح	5	to become clearer, be clarified, get cleared up
توَضّى	يِتوَضّى	5	to wash (intrans), perform ritual ablution for prayer
توَفَّر	يِتوَفَّر	5	to abound, be numerous, be abundant
توَفّى	يِتوَفّى	5	to die, pass away
توَقَّع	يِتوَقَّع	5	to expect
توَقَّف	يِتوَقَّف	5	to stop, halt, cease (intrans), be arrested, to depend
توَكَّل	يِتوَكَّل	5	to have confidence in, trust on, have faith in
توَلَّد	يِتوَلَّد	5	to be born, originate, be created, develop
توَلدَن	يِتوَلدَن		to behave childishly
تيَتَّم	يِتيَتَّم	5	to be orphaned
تَيَّس	يتَيَّس	2	to behave stupidly or foolishly
ثَبَّت	يثَبَّت	2	to fix, make fast, fasten, strengthen, establish, prove, to give tenure
جا/إجا	ييجي/إيجي		to come, to arrive
جاب	يجيب	1	to bring, to give birth
جابى	يِجابي	3	to collect, levy (taxes)
جاز	يجوز	1	to be possible, be permissible, be allowed
جازَف	يجازَف	3	to take risks, to gamble
جازى	يجازي	3	to give someone what they deserve, to reward, to punish
جاع	يجوع	1	to be hungry, to starve
جاكَر	يجاكَر	3	to contradict deliberately, to annoy, to tease
جامَع	يجامَع	3	to have sex with
جاوَب	يجاوَب	3	to answer
جَبَر	يُجبُر	1	to force, compell
جَبصَن	يجَبصَن		to put in plaster
جَبَل	يِجبَل	1	to mix (concrete)
جَحَر	يِجحَر	1	to look at angrily/severely
جَخّ	يجُخّ	1	to be clothes-conscious, to show off, be a showoff
جَدّ	يجَدّ	1	to pick (olives)
جَدَّد	يجَدَّد	2	to renew, redo
جَدَّر	يجَدَّر	2	to catch smallpox
جَدَّف	يجَدَّف	2	to row (a boat)
جَدَّل	يجَدَّل	2	to plait, to braid
جَذَب	يِجذَب	1	to attract
جَرّ	يجُرّ	1	to drag, to pull
جَرَّب	يجَرَّب	2	to try, to test
جَرَح	يِجرَح	1	to hurt, wound, injure, to offend
جَرَّد	يجَرَّد	2	to strip (trans), divest of
جَرَش	يُجرُش	1	to grind
جَرَف	يِجرَف	1	to sweep away, carry away
جَرى	يِجري	1	to run, to flow, to happen, occur
جَزّ	يجَزّ	1	to shear
جَسَّر	يجَسَّر	2	to bridge
جَعَّر	يجَعَّر	2	to moo
جَعَل	يِجعَل	1	to cause, make [something happen]
جَعلَك	يجَعلَك		to crease, crumple
جَفَّف	يجَفَّف	2	to dry, to drain (trans)
جَفَّل	يجَفَّل	2	to startle, scare, frighten
جَلَب	يِجلَب	1	to attract
جَلَّد	يجَلَّد	2	to bind (book) (originally: to cover with leather)
جَلَّس	يجَلَّس	2	to straighten out
جَلى	يِجلي	1	to wash up, wash (dishes), to polish
جَمَّد	يجَمَّد	2	to freeze, congeal, thicken (trans)
جِمَد	يِجمَد	1	to freeze (intrans), become thick, harden, solidify
جَمرَك	يجَمرَك		to clear through customs
جَمَع	يِجمَع	1	to gather, collect, bring together, add (math), pluralize (gram)
جَمَّع	يجَمَّع	2	to gather, assemble, bring together, collect
جَمَل	يِجمَل	1	to gather, assemble into one group, to generalize
جَمَّل	يجَمَّل	2	to make beautiful, make pretty, beautify
جَنَّد	يجَنَّد	2	to draft, conscript, recruit
جَنَّن	يجَنَّن	2	to drive insane, drive mad (irritation, anger, enthusiasm)
جَهَّز	يجَهَّز	2	to prepare, supply, equip
جِهَل	يِجهَل	1	to be ignorant of, to not know
جَوَّز	يجَوَّز	2	to give in marriage, marry off
جَوَّع	يجَوَّع	2	to starve someone
جَيَّب	يجَيَّب	2	to assist at a birth, deliver a baby
حاد	يحيد	1	to deviate, swerve, stray, digress
حارَب	يحارَب	3	to fight (against), combat, wage war on
حاصَر	يحاصَر	3	to besiege
حاضَر	يحاضَر	3	to lecture
حافَظ	يحافَظ	3	to maintain, preserve, keep, observe
حاكى	يحاكي	3	to talk to, address
حام	يحوم	1	to wander around
حاوَل	يحاوَل	3	to try, attempt
حَبّ	يحَبّ	1	to love, like, to want
حَبَّب	يحَبَّب	2	to endear, cause to be liked, make popular
حَبَس	يِحبَس	1	to imprison, lock up, shut up
حِبَل	يِحبَل	1	to get pregnant
حَثّ	يحَثّ	1	to urge, incite
حَجّ	يحَجّ	1	to make a pilgrimage
حَجَّر	يحَجَّر	2	to fur up, become furred (covered in limescale)
حَجَز	يِحجَز	1	to confiscate, impound, sieze, garnish, attach, reserve, keep
حَدّ	يحَدّ	1	to mourn, wear mourning
حَدَث	يَحدُث	1	to happen, occur
حَدَّد	يحَدَّد	2	to define, fix, set, to limit
حَدَف	يِحدَف	1	to swerve, veer, deviate
حَذَّر	يحَذَّر	2	to warn, caution
حَرَث	يُحرُث	1	to plow, cultivate
حِرَد	يِحرَد	1	to be in a temper, to sulk
حَرَّر	يحَرَّر	2	to release, set free, liberate, to edit
حَرَس	يِحرَس	1	to guard, be on guard, keep watch
حَرَّض	يحَرَّض	2	to incite, goad
حَرَف	يِحرَف	1	to deviate, stray
حَرَق	يِحرَق	1	to burn (trans)
حَرَّك	يبحَرَّك	2	to move, set in motion, to vocalize, vowelize, put in vowels
حَركَش	يحَركَش		to provoke, to haress, pester, badger
حَرَم	يِحرَم	1	to deprive, deny, dispossess
حَرَّم	يحَرَّم	2	to declare sacred, to declare unlawful, to forbid
حَزَّر	يحَزَّر	2	to ask a riddle
حِزَر	يِحزَر	1	to guess, to solve a riddle
حِزِر	يحْزَر		to guess, to figure out
حَزَّق	يحَزَّق	2	to hiccup
حَسّ	يحَسّ	1	to feel
حَسَب	يِحسَب	1	to calculate, count, reckon
حَسَّب	يحَسَّب	2	to think (something is something), consider (something/one to be something)
حَسَد	يِحسَد	1	to envy, be envious
حَسَّس	يحَسَّس	2	to cause to feel, give the feeling (that), make people feel (that)
حَسَم	يِحسَم	1	to cut, to decide, to settle
حَسمَس	يحَسمَس		to feel one's way
حَسَّن	يحَسَّن	2	to improve
حَشّر	يُحشُر	2	to push, crowd, squash together
حَشَّش	يحَشَّش	2	to smoke hashish, to use cocaine/heroin (???)
حَشى	يِحشي	1	to stuff, fill
حَصَّب	يحَصَّب	2	to catch measles
حَصَد	يٌحصُد	1	to harvest, reap
حَصَل	يَحصُل	1	to happen, occur, to obtain, to get (على) something
حِصَل	يِحصَل	1	to obtain, get
حَصَّن	يحَصَّن	2	to fortify, entrench
حَصّى	يِحصّي	2	to count, to gather statistics
حَضَر	يِحضَر	1	to attend, be present
حَضَّر	يحَضَّر	2	to prepare
حَطّ	يحُطّ	1	to put, place
حَطَّم	يحَطَّم	2	to break, smash
حَفَر	يُحفُر	1	to dig, excavate, carve
حِفَظ	يِحفَظ	1	to guard, preserve, take care, to memorize, have memorized
حِفْظ	يحْفَظ		to guard, to preserve, to memorize
حَقّ	يحَقّ	1	to have the right to, to be entitled to, to deserve (lit. to be due to)
حَقَد	يِحقَد	1	to resent, feel resentful, bear a grudge
حَقَّق	يحَقَّق	2	to realize, fulfil, to check, verify, to investigate, interrogate
حَقَن	يُحقُن	1	to inject
حَكّ	يحَكّ	1	to scratch, scrape, rub
حَكَم	يُحكُم	1	to judge, sentence, to rule
حَكى	يِحكي	1	to talk, speak, tell, say
حَكَى	يحْكي		to speak, to tell
حَلّ	يحَلّ	1	to solve, release, undo, untie, untether, to dissolve, dismantle, break up, to finish, to occupy (a place), to descend, to fade, run (in the wash)
حَلَب	يِحلَب	1	to milk
حَلَّس	يحَلَّس	2	to stroke, caress
حَلَف	يِحلَف	1	to swear, take an oath
حَلَق	يِحلَق	1	to get a haircut, to get a shave
حَلَّق	يحَلَّق	2	to hover
حَلَّل	يحَلَّل	2	to analyze
حِلَم	يِحلَم	1	to dream
حَلَّى	يحَلّي		to sweeten
حَمَّس	يحَمَّس	2	to cheer on, arouse enthusiasm
حَمَّص	يحَمَّص	2	to roast (coffee, seeds, etc)
حَمّص	يحَمِّص		to roast, to toast, to fry
حَمَّض	يحَمَّض	2	to turn sour, to develop (film)
حَمَّق	يحَمَّق	2	to anger, make angry
حِمَق	يِحمَق	1	to lose one's temper, to become angry
حَمَل	يِحمَل	1	to carry, bear, to take time, last (Jerusalem)
حَمَّل	يحَمَّل	2	to load, cause to bear
حَمَّم	يحَمَّم	2	to bathe, give a bath to
حَمى	يِحمي	1	to defend, guard, protect
حَمّى	يحَمّي	2	to warm something up
حِمي	يِحمى	1	to become hot, heat up (intrans)
حَنّ	يحَنّ	1	to long, yearn for, be nostalgic for, miss
حَنَّط	يحَنَّط	2	to embalm, stuff
حَنى	يِحني	1	to bow (trans)
حَنّى	يحَنّي	2	to henna
حَوَّس	يحَوَّس	2	to fry (onions)
حَوَّش	يحَوَّش	2	to gather, accumulate, save up
حَوَّط	يحَوَّط	2	to encircle, surround
حَوَّل	يحَوَّل	2	to turn into, to transfer, pass on, divert
حَوى	يِحوي	1	to contain, include
حَيَّر	يحَيَّر	2	to confuse, disconcert, embarrass
حَيّى	يحَيّي	2	to keep alive, to greet, to salute
خاب	يخيب	1	to be disappointed
خاض	يخوض	1	to wade
خاطَر	يخاطَر	3	to risk
خاف	يخاف	1	to be afraid
خالَط	يخالَط	3	to mingle with, mix with, to come into contact with
خالَف	يخالَف	3	to oppose, differ, disagree with, to contravene, break (the law)
خان	يخون	1	to betray, decieve, be unfaithful
خاوَز	يخَوَز	3	to treat preferentially, to favor
خَايَل	يخايَل	3	to be transparent
خَبَّر	يخَبَّر	2	to inform, let know
خَبَز	يِخبَز	1	to bake
خَبَّص	يخَبَّص	2	to paddle, dabble, to skimp, do a bad job
خَبَط	يُخبُط	1	to hit, beat, strike
خَبَّط	يخَبَّط	2	to knock hard, hit several times, beat, to hammer
خَبَّى	يخَبّي		to hide
خَبّى	يخَبّي	2	to hide, conceal
خَتَم	يِختَم	1	to conclude, to seal, stamp, postmark
خَتيَر	يخَتيَر		to age
خِجَل	يِخجَل	1	to be embarrassed, be ashamed
خَدَش	يُخدُش	1	to scratch
خَدَع	يخدَع	1	to decieve, cheat
خَدَم	يِخدَم	1	to serve
خَرّ	يخُرّ	1	to buzz, to gurgle
خَرَّب	يخَرَّب	2	to destroy, damage, break, cause to break down
خِرَب	يِخرَب	1	to be destroyed, to deteriorate, spoil, to break down
خَرَب/أَخرَب	يِخرَب	1	to destroy
خَربَش	يخَربَش		to scratch, to scribble
خَربَط	يخَربَط		to confuse, disarrange, mix up, muddle, to talk in a confused manner, to ramble,
خَرَج	يُخرُج	1	to go out
خَرَّج	يخَرَّج	2	to graduate, give a degree
خَرخَر	يخَرخَر	[4]	to buzz
خِرَس	يِخرَس	1	to be silent, keep quiet, be mute
خَرَط	يُخرُط	1	to turn, shape on a lathe, to brag, to tell tall tales
خَرَّف	يخَرَّف	2	to tell, recount, relate
خَرَق	يُخرُق	1	to violate, break, to penetrate, pass through
خَرَّم	يخَرَّم	2	to perforate, make holes
خِري	يِخرى	1	to shit
خَزَق	يِخزَق	1	to make a hole, to pierce
خَزَّق	يخَزَّق	2	to punch, make several holes
خَزَن	يِخزَن	1	to store, accumulate, gather
خَزَّن	يخَزَّن	2	to store
خَزى	يِخزي	1	to dishonor, disgrace, to shame, embarrass
خَسّ	يخَسّ	1	to decrease, become less, to be lacking, to lose weight
خِسَر	يِخسَر	1	to lose, incur a loss
خِسِر	يخْسَر		to incur loss
خَشّ	يخُشّ	1	to come in, go in, enter (Jerusalem, Hebron)
خَشخَش	يخَشخَش		to crackle, to rustle
خَصّ	يخُصّ	1	to concern, apply to, have to do with
خَصَّص	يخَصَّص	2	to designate, set aside, allocate
خَصَم	يُخصُم	1	to deduct, subtract, to give a discount, knock something off (the price)
خَصى	يِخصي	1	to castrate, geld
خَضّ	يخُضّ	1	to shake, jolt, to churn
خَطَب	يُخطُب	1	to make a speech, to deliver a sermon, preach, to get engaged
خَطَر	يُخطُر	1	to come to mind, occur to
خَطَّط	يخَطَّط	2	to plan
خَطَف	يُخطُف	1	to sieze, snatch, grab
خَفّ	يخَفّ	1	to become lighter/less severe, to decrease, become weaker
خَفَّض	يخَفَّض	2	to reduce, decrease, lower, devalue (currency)
خَفَّف	يخَفَّف	2	to make lighter/easier, to reduce
خَفَق	يُخفُق	1	to beat, to whip, beat (eggs, cream, etc)
خِفي	يِخفى	1	to be concealed, be imperceptible, be invisible, to escape attention
خَلّ	يخَلّ	1	to violate, break (a promise), to upset, disturb
خَلَّد	يخَلَّد	2	to perpetuate, eternalize, immortalize
خَلَص	يُخلُص	1	to be finished, be over
خَلَّص	يخَلَّص	2	to free, extricate, save, rescue, to finish, complete
خِلِص	يخْلَص		to finish
خَلَط	يُخلُط	1	to mix, blend
خَلَع	يِخلَع	1	to take out, remove, to break down something
خَلَف	يِخلَف	1	to replace, to reward
خَلَّف	يخَلَّف	2	to give birth to, to produce children / descendants
خَلَق	يِخلَق	1	to create, to make, cause
خِلَق	يِخلَق	1	to be born, be created
خَلَّل	يخَلَّل	2	to ferment (intrans), to pickle
خَلَّى	يخَلّي		to let be
خَلّى	يخَلّي		to leave something, to let, make (someone do something)
خَلّي	يخَلّي		to let, to stay
خِلي	يِخلى	1	to become empty, be empty
خِمَر	يِخمَر	1	to ferment, rise (dough)
خَمَّن	يخَمَّن	2	to estimate, assess, appraise
خَنّ	يخَنّ	1	to twang
خَنَب	يِخنَب	1	to speak through one's nose, talk nasally
خَنخَن	يخَنخَن	[4]	to twang repeatedly, to speak through one's nose, speak nasally
خَنَق	يِخنَق	1	to strangle, throttle, suffocate
خَوَّف	يخَوَّف	2	to frighten, scare
خَوَّن	يخَوَّن	2	to distrust
خَوى	يخاوي	1	to treat like a brother
خَيَّب	يخَيَّب	2	to disappoint (usually followed by أَمَل(ي/ك/ه/ها/هم)ء)x
خَيَّط	يخَيَّط	2	to sew
خَيَّم	يخَيَّم	2	to camp, encamp, to reign, prevail (mood, atmosphere)
داب	يدوب	1	to dissolve, melt, thaw
داخ	يدوخ	1	to be dizzy
دار	يدور	1	to revolve, turn, roam, travel around, wander about
دار	يدير	1	to turn something, direct (sth) toward, manage, direct, run, pour out
دارى	يداري	3	to conceal, hide, cover up, protect, watch over, look out for
دافَع	يدافَع	3	to protect, defend
دَافَع	يدَافِع		to defend, to stand up for
داق	يدوق	1	to taste
دام	يدوم	1	to last, be constant
داوَم	يداوَم	3	to work (fixed, regular hours)
دايَق	يدايَق	3	to bother, irritate, harass
دايَن	يدايَن	3	to lend (money)
دَبّ	يدَبّ	1	to push, shove, push over, knock down
دَبَح	يِدبَح	1	to slaughter, kill, massacre
دَبَّر	يدَبَّر	2	to arrange, put in order
دَبّر	يدَبِّر		to manage
دَبَغ	يدبغ	1	to tan (a skin or hide in order to convert it to leather)
دَبَّق	يدَبَّق	2	to be sticky
دَبَك	يِدبَك	1	to stamp your foot, dance the dabke
دَبَّك	يدَبَّك	2	to stamp your feet
دِبَل	يِدبَل	1	to wilt, to weather
دَبلَج	يدبلج		to dub (a film) (from french)
دَحرَج	يدَحرَج		to roll something
دَحَش	يِدحَش	1	to push in, insert, thrust
دَخَل	يُدخُل	1	to enter
دَخَّل	يدَخَّل	2	to bring in, let in, insert, put in
دَخَّن	يدَخَّن	2	to smoke
دَرَّب	يدَرَّب	2	to train
دَربَك	يدَربَك		to play the darabukka
دَردَش	يدردش		to chat
دَرَز	يُدرُز	1	to hem
دَرَس	يُدرُس	1	to study, to thresh wheat
دَرّى	يدَرّي	2	to scatter, winnow
دِري	يِدرى	1	to know
دَشَّر	يدَشَّر	2	to leave
دَشَّن	يدَشَّن	2	to inaugurate, consecrate to wear/use for the first time
دَعدَر	يدعدر		to bruise someone
دَعَس	يِدعَس	1	to tread on, to trample
دَعَك	يِدعَك	1	to knead, massage (strongly), to give someone a hard time
دَعَم	يِدعَم	1	to support, to subsidize
دَعى	يِدعي	1	to bless, wish well
دَعى	يِدعي	1	to pray for
دَعى	يِدعي	1	to curse, wish against
دَغَّم	يدَغَّم	2	to get mumps
دَفَش	يِدفَش	1	to push, shove
دَفَع	يِدفَع	1	to pay, impel, motivate, drive, make (someone do something), push, shove
دَفَن	يِدفَن	1	to bury
دَفّى	يدَفّي	2	to heat, keep warm
دِفي	يِدفى	1	to warm up (intrans), become warm
دَقّ	يدُق	1	to knock, bang, hammer, ring, grind
دَقَر	يدَقَر	1	to touch lightly, to graze
دَقَّر	يدَقَّر	2	to get stuck, stop short and be unable to continue
دَقَّق	يدَقَّق	2	to be accurate, be precise, be meticulous
دَلّ	يدَلّ	1	to show, indicate, guide, show the way
دَلَّع	يدَلَّع	2	to spoil, pamper, make too much fuss of
دَلَف	يِدلَف	1	to leak
دَلَّك	يدَلَّك	2	to massage
دَلَّل	يدَلَّل	2	to pamper, make a pet of
دَلّى	يدَلّي	2	to lower, to dangle
دَمَج	يِدمَج	1	to mix, integrate
دَمدَم	يدَمدَم	[4]	to sing quietly to oneself, croon, hum, to grumble to oneself
دَمَّر	يدَمَّر	2	to destroy, demolish, ruin, wreck
دَندَل	يدَندَل		to dangle
دَندَن	يدَندَن	[4]	to hum
دَنَّس	يدَنَّس	2	to desecrate
دَهَّب	يدَهَّب	2	to gild
دَهَس	يِدهَس	1	to run over, knock down
دَهَك	يِدهَك	1	to run over, knock down
دَهلَز	يدَهلَز		to suck up to, brownnose
دَهَن	يِدهَن	1	to paint, to coat, spread
دَهَّن	يدَهَّن	2	to coat, to spread
دَوَّب	يدَوَّب	2	to dissolve, melt, thaw, defrost
دَوَّخ	يدَوَّخ	2	to make dizzy
دَوَّر	يدَوَّر	2	to turn something, to search/look for
دوزَن	يدوزَن		to tune
دَوزَن	يدَوزِن		to tune a musical instrument
دَوَش	يِدوَش	1	to confuse, upset, disturb, fluster
دَوَّل	يدَوَّل	2	to internationalize
دَيَّق	يدَيَّق	2	to narrow, take in (clothes), to irritate, bother
ذاق	يدوق		to taste
ذَكَر	يذْكُر		to remember
ذَكَّر	يذَكِّر		to remind
رَأى	يَرى	1	to see (more formal)
راب	يروب	1	to curdle, go off, turn sour
راج	يروج	1	to be in demand, to sell like hot cakes
راجَع	يراجَع	3	to consult, apply to, to revise, go over, check, to repeat, look back on, to rehearse, to vomit
راح	يروح	1	to go, attend, go away, disappear
راد	يريد	1	to want
راعى	يراعي	3	to consider, respect, treat well, be pleasant to
رافَق	يرافَق	3	to accompany
راق	يروق	1	to become clear, become limpid (of liquid), to calm down, see things clearly
راقَب	يراقَب	3	to supervise, monitor, check up on, keep an eye on, to censor
راهَن	يراهَن	3	to bet, to wager
رَبَح	يُربُح	1	to sit on eggs, be broody
رَبَّح	يرَبَّح	2	to profit (trans), make money for
رِبَح	يِربَح	1	to make a profit, to win
رَبَط	يُربُط	1	to tie up, tie down, attach, secure, bind, to keep someone waiting in vain
رَبَّط	يرَبَّط	2	to tie up (thoroughly), truss up
رَبّى	يرَبّي	2	to bring up, raise (a child), to educate, to grow (one's hair, beard), to keep, breed, rear (animals)
رِبي	يِربى	1	to grow up, be brought up
رَتَّب	يرَتَّب	2	to organize, tidy up, put in order
رَتَّل	يرَتَّل	2	to chant, sing a hymn (church), to recite the Qur'an
رَتى	يِرتي	1	to darn, sew, etc
رَجّ	يرُجّ	1	to tremble, wobble, shake
رَجَّع	يرَجَّع	2	to give back, put back, return
رِجَع	يِرجَع	1	to return, repeat, become once more, to be up to, be down to, depend on, to go back on
رِجِع	يرْجَع		to return, to go & come back
رَجَف	يِرجَف	1	to tremble, shiver, shake (intrans)
رَحَّب	يرَحَّب	2	to say مَرحَبا, to welcome
رَحَل	يِرحَل	1	to wander, roam, travel, to move towns, to emigrate, to die, pass away
رَحَم	يِرحَم	1	to have mercy on
رَخَّص	يرَخَّص	2	to reduce in price, make cheaper
رَخّى	يرَخّي	2	to relax, loosen, slacken, to dilute, to thin
رَدّ	يرَدّ	1	to reply, respond, react, to prompt, whisper the answer to a classmate
رَدَع	يِردَع	1	to deter, prevent
رَزَق	يِرزَق	1	to provide (with livelihood), to bless with (a child) (of God)
رِزَق	يِرزَق	1	to make a living, be blessed with
رَسَب	يِرسَب	1	to sink, to fail (exam), to repeat a year (school)
رَسَّب	يرَسَّب	2	to sink (another one)
رَسَم	يِرسَم	1	to draw, sketch
رَسى	يِرسي	1	to anchor, cast anchor, to sink, to have fall to one's lot, to be selected for
رَسّى	يرَسّي	2	to sink (intrans)
رَشّ	يرُشّ	1	to crush
رَشّ	يرُشّ	1	to spray, sprinkle
رَشَح	يِرشَح	1	to sweat (of a water container etc)
رَشَّح	يرَشَّح	2	to nominate (candidate), to catch cold
رَشَق	يُرشُق	1	to whitewash
رَشى	يِرشي	1	to bribe
رَصرَص	يرَصرَص	[4]	to fill (tooth)
رَضّ	يرُضّ	1	to bruise
رَضَخ	يِرضَخ	1	to give in, let someone have their way
رَضَّع	يرَضَّع	2	to suckle, breastfeed, nurse (trans)
رِضَع	يِرضَع	1	to suck, suckle, breastfeed, nurse (intrans)
رِضي	يِرضى	1	to be pleased, be satisfied, be content, to agree, approve, consent
رَعَد	يِرعَد	1	to thunder, be thundery
رَعى	يِرعى	1	to graze, to lead (flock(s)), to pasture, take out to the pasture, to be itchy, to itch, have an itch
رَغرَغ	يرَغرَغ	[4]	to gargle
رَغى	يِرغي	1	to lather, foam, froth
رَفرَف	يرَفرَف	[4]	to flap, flutter
رَفَص	يُرفُص	1	to kick
رَفَض	يُرفُض	1	to refuse, reject, turn down
رَفَع	يِرفَع	1	to raise, put up, make louder, turn up (volume), to lodge (complaint etc), to press (charges)
رَقّ	يرَقّ	1	to roll out, flatten
رَقَص	يُرقُص	1	to dance
رَقَّع	يرَقَّع	2	to patch, mend, repair (clothes)
رَقَّم	يرَقَّم	2	to number
رَقّى	يرَقّي	2	to promote, to improve the standard
رَكَّب	يرَكَّب	2	to give (someone) a ride, to assemble, put together, compose, make up, to graft
رِكَب	يِركَب	1	to ride, to get on
رِكِب	يرْكَب		to ride
رَكَد	يِركَد	1	to calm down
رَكَز	يِركَز	1	to settle down, to set down, put down
رَكَّز	يرَكَّز	2	to concentrate, focus
رَكَض	يُركُض	1	to run
رَكَع	يِركَع	1	to prostrate oneself, to kneel down
رَكَن	يِركَن	1	to rely
رَكى	يِركي	1	to lean (trans and intrans)
رَمَز	يِرمَز	1	to symbolize, indicate
رَمَش	يِرمَش	1	to blink (once)
رَمَّش	يرَمَّش	2	to blink repeatedly
رَمى	يِرمي	1	to throw
رَمَى	يرْمي		to throw
رَنّ	يرَنّ	1	to ring (intrans)
رَنَّخ	يرَنَّخ	2	to soak (trans)
رَهَن	يِرهَن	1	to pawn, to mortage
رَوَّح	يرَوَّح	2	to cause to depart, to go home
رَوّح	يرَوِّح	1	to go home, to get rid of, remove, kill, injur
رَوَّس	يرَوَّس	2	to sharpen
رَوَّق	يرَوَّق	2	to calm, pacify
رَوى	يِروي	1	to irrigate, to quench (thirst), to drench, soak, saturate
رَيَّح	يرَيَّح	2	to calm, soothe, to give a rest, let someone take it easy
رَيَّل	يرَيَّل	2	to salivate, dribble, drool
زاح	يزيح	1	to move over, move away, move aside
زاد	يزيد	1	to add, be left over, be surplus, to exceed, to exaggerate
زار	يزور	1	to visit
زاقى	يزاقي	3	to creak, to squeak
زال	يزول	1	to go away, to leave, disappear
زان	يزين	1	to weigh
زَبَّل	يزَبَّل	2	to fertilize
زَتّ	يزَتّ	1	to throw, throw away, throw out
زَحَف	يِزحَف	1	to crawl, creep, slither
زَخّ	يزَخّ	1	to pour, to down rain
زَخرَف	يزَخرَف		to decorate
زَرَّر	يزَرَّر	2	to button, button up
زَرزَب	يزَرزَب	[4]	to cheat (at games) (in some areas)
زَرَع	يزْرَع		to sow
زَرَق	يُزرَق	1	to slip in/out, sneak in/out
زَعزَع	يزَعزَع		to shake, undermine
زَعَّل	يزَعَّل	2	to annoy, upset, irritate, make angry, upset, distress
زِعَل	يِزعَل	1	to be angry, be annoyed, be irritated, be upset, be distressed
زِعِل	يزْعَل		to be angry
زَغَّر	يزَغَّر	2	to reduce, decrease, make smaller, make younger, think someone is younger than he is
زَغرَت	يزَغرَت		to make that trilling sound
زَغزَغ	يزَغزَغ	[4]	to tickle
زَفَّت	يزَفَّت	2	to tar
زَقّ	يزُقّ	1	to carry (from place to place), to unload, to shove, push, jostle
زَقزَق	يزَقزَف	[4]	to chirp, tweet, twitter, sing (birds)
زَقَط	يُزقُط	1	to catch
زَقَّف	يزَقَّف	2	to clap, applaud
زَكَر	يُزكُر	1	to mention, repeat, refer to, to quote
زَكَّر	يزَكَّر	2	to remind
زَكزَك	يزَكزَك	[4]	to tickle (in some areas
زَمَّر	يزَمَّر	2	to honk, hoot (horn)
زَن	يزَنّ	1	to buzz (another one)
زَنى	يِزني	1	to commit adultury, fornicate
زَهَّر	يزَهَّر	2	to flower, bloom, be in bloom
زَهَّق	يزَهَّق	2	to bore someone, make someone fed up, cause someone to be sick of
زِهَق	يِزهَق	1	to become fed up with, get tired of, have enough of, get bored
زِهِق	يزْهَق		to be fed up
زَوَّد	يزَوَّد	2	to supply, equip
زَوَّر	يزَوَّر	2	to take someone for a visit/trip, to forge, to fake
زِوَر	يِزوَر	1	to have yo food go down the wrong way, swallow the wrong way
زَيَّت	يزَيَّت	2	to oil
زَيَّف	يزَيَّف	2	to forge, fake, counterfeit
سَأَل	يِسأَل	1	to ask
ساب	يسيب	1	to leave (trans) - not widely used
ساعَد	يساعَد	3	to help
سافَر	يسافَر	3	to travel, set out, go, leave
ساق	يسوق	1	to drive (vehicle)
سال	يسيل	1	to flow, stream, run, leak
سامَح	يسامَح	3	to forgive
ساهَم	يساهَم	3	to contribute, help out, do your bit, participate
ساوى	يساوي	3	to arrange, fix, mend, repair, straighten out, to do
سايَر	يسايَر	3	to be accommodating, be amenable, be considerate
سَبّ	يسَبّ	1	to curse, swear
سَبَّب	يسَبَّب	2	to cause, lead to
سَبّب	يسَبِّب		to cause, to bring about
سَبَح	يِسبَح	1	to swim, bathe
سَبَّح	يسَبَّح	2	to praise, to make swim, help swim, teach to swim
سَبَغ	يُسبُغ	1	to dye
سَبَق	يُسبُق	1	to overtake, outstrip, leave behind, precede, arrive before
سَبَّق	يسَبَّق	2	to bring forward, advance, to be fast (watch, clock)
سَبَك	يُسبُك	1	to cast, smelt, pour into a mould (metal)
سَتَر	يُستُر	1	to cover, hide, protect from harm, protect someone's reputation
سَتَّر	يسَتَّر	2	to cover, protect, esp. body parts
سَجَّل	يسَجَّل	2	to record, register, sign up for, sign on
سَحَب	يِسحَب	1	to pull, draw, to withdraw, take out (money from account), to extract (confession), to take (back), to bring in, take in (money), to draw (lottery)
سَحَج	يِسحَج	1	to mark time by clapping hands
سَحَر	يِسحَر	1	to enchant, charm, put under a spell
سَحسَل	يسَحسَل		to slide (on playgroung slide)
سَحَل	يِسحَل	1	to slip off, slip down
سَخَن	يُسخُن	1	to warm up, heat up (intrans)
سَخَّن	يسَخَّن	2	to warm/heat something up
سَدّ	يسَدّ	1	to block, seal off, barricade, to pay, settle (debt)
سَدَّق	يسَدَّق	2	to believe (not to believe IN), to long for impatiently, be unable to wait for
سَرّ	يسُرّ	1	to delight, make happy
سَرَح	يِسرَح	1	to herd, take out to pasture, to roam, wander, to be preoccupied/distracted
سَرَّح	يسَرَّح	2	to release, let go, dismiss, discharge, to demobilize, to comb, do (hair)
سَرَق	يُسرُق	1	to steal
سَرى	يِسري	1	to be valid, be effective, to apply
سَعَل	يُسعُل	1	to cough
سَفَك	يِسفَك	1	to shed (blood)
سَقَط	يُسقُط	1	to fall, fail
سَقَّط	يسَقَّط	2	to cause to fail, to fail (trans)
سَقى	يِسقي	1	to water, irrigate, to give someone a drink
سَكَت	يُسكُت	1	to be silent, keep quiet, shut up, say nothing
سَكَّت	يسَكَّت	2	to silence, shut someone up
سَكّت	يسَكِّت		to silence
سَكَّر	يسَكَّر	2	to close, to lock
سِكَر	يِسكَر	1	to get drunk
سِكِر	يسْكَر		to get drunk
سَكَن	يُسكُن	1	to live, stay, reside
سَكَّن	يسَكَّن	2	to calm, reassure, alleviate, relieve
سَلَّح	يسَلَّح	2	to arm, supply with weapons
سَلَّف	يسَلَّف	2	to lend (money)
سَلَق	يُسلُق	1	to boil (trans)
سَلَك	يُسلُك	1	to go smoothly, to get used to, become accustomed to, find a way to get along with
سَلَّك	يسَلَّك	2	to lay wire, ie to get things flowing/moving
سَلَّم	يسَلَّم	2	to greet, give your regards, to deliver, hand over, give, to surrender (trans and intrans), to preserve, protect from harm
سِلَم	يِسلَم	1	to be well, be safe, be unharmed
سَلَّى	يسَلّي		to entertain
سَلّى	يسَلّي	2	to amuse, entertain, divert
سَمَح	يِسمَح	1	to permit, allow, let, grant
سَمَّع	يسَمَّع	2	to make hear, let hear, to hint, convey a message in a roundabout way
سِمَع	يِسمَع	1	to hear, listen
سِمِع	يسْمَع		to hear
سَمَّك	يسَمَّك	2	to thicken (trans)
سَمَّن	يسَمَّن	2	to fatten, fatten up (trans)
سَمَّى	يسَمّى		to name
سَمّى	يسَمّي	2	to name, to call, to say بإِسمِ الله, say grace, etc
سَنّ	يسَنّ	1	to grind, sharpen, whet
سَنَد	يِسنَد	1	to prop up, support
سَنَّن	يسَنَّن	2	to teethe, cut one's teeth
سِهَر	يِسهَر	1	to stay up late, to spend the evening
سِهِر	يسْهَر		to stay up late; to spend the evening
سَهَّل	يسَهَّل	2	to make easy, make easier, make more convenient
سَهى	يِسهي	1	to be inattentive, stop paying attention, get distracted
سَوَّد	يسَوَّد	2	to blacken
سَوَّس	يسَوَّس	2	to become worm eaten, to decay (tooth)
سولَف	يسولَف		to tell, relate (stories), to talk, converse (old fashioned word)
سَوَّى	يسَوّي		to do, to arrange
سَوّى	يسَوّي	2	to straighten, arrange, put in order, to do
سِوي	يِسوى	1	to be equal, be worth, have value
سَيَّج	يسَيَّج	2	to fence, hedge
سَيطَر	يسَيطَر		to control, dominate, take control of
شاء	يَشاء	1	to want, wish
شاب	يشيب	1	to turn white (hair), to get grey hairs, to become white/gray haired
شارَط	يشارَط	3	to impose a condition, make something conditional upon, to bet, to wager
شاع	يشيع	1	to spread (intrans)
شاغَب	يشاغَب	3	to cause trouble, cause a disturbance
شاف	يشوف	1	to see, to consider, watch, find
شال	يشيل	1	to remove, take off, dismiss, take away, move away
شاهَد	يشاهَد	3	to watch, observe, view, look at
شاوَر	يشاوَر	3	to consult, ask for advice
شَبَّر	يشَبَّر	2	to measure in handspans
شِبَع	يِشبَع	1	to become satisfied / full / replete / sated, to have enough to eat, to become fed up, get sick of
شِبِع	يشْبَع		to be satisfied
شَبَك	يِشبَك	1	to stir up trouble
شَبَّك	يشَبَّك	2	to plait, weave, twine
شِبِه	يِشبَه	1	to resemble
شَبّى	يشَبّي	2	to mate (trans)
شَتَل	يِشتِل	1	to plant, to transplant
شَتَم	يِشتِم	1	to swear, curse
شَتّى	يشَتّي	2	to rain
شَجَّع	يشَجَّع	2	to encourage, embolden, hearten, bolster one's courage
شَحبَر	يشَحبَر		to scorch, blacken (by burning), cover with soot
شَحَد	يِشحَد	1	to beg, ask for charity
شَحَّد	يشَحَّد	2	to donate, give as charity
شَحَط	يِشحَط	1	to drag, trail, to strike (a match), to skid, to draw a line
شَحَّم	يشَحَّم	2	to grease (engine)
شَحَن	يِشحَن	1	to load, charge/recharge (battery etc)
شَخّ	يشُخّ	1	to urinate, relieve yourself
شَخَر/شَنخَر/شَخوَر	يِشخَر/يشَنخَر/يشَخوَر		to snore
شَخَّص	يشَخَّص	2	to diagnose
شَدّ	يشَدّ	1	to exert pressure, pull, draw tight, to tie, tighten, fasten, make fast, to be strict with, to support, stand up for, rally around
شَدَّد	يشَدَّد	2	to be strict, be severe, get tough, to emphasize
شَذ	يشَذّ	1	to deviate, to stand out, be irregular, be unusual, be exceptional
شَرَّب	يشَرَّب	2	to give something to drink, to drench, soak, to imbue, instil
شِرِب	يشْرَب		to drink
شَربَط/شَلبَط	يشَربَط/يشَلبَط		to be on heat
شَربَك	يشَربَك		to tangle (trans)
شَرَّح	يشَرَّح	2	to cut up, slice up, to dissect, perform an autopsy
شَرَد	يُشرُد	1	to flee, run away, take flight, to wander, roam, stray
شَرَّد	يشَرَّد	2	to drive away, chase away, put to flight, to scatter, to exile, deport, expel, drive out
شَرَّش	يشَرَّش	2	to develop varicose veins
شَرشَح	يشَرشَح	[4]	to wear out, to treat badly, humiliate, abuse
شَرَط	يُشرُط	1	to tear (trans)
شَرَّط	يشَرَّط	2	to tear repeatedly, to impose a condition
شَرَّف	يشَرَّف	2	to respect, honor
شَرَق	يُشرُق	1	to gulp down, to slurp, suck in / suck up noisily
شَرَك	يِشرَك	1	to participate, take part, join in
شَطَب	يُشطَب	1	to erase, rub out, cross out, cross off
شَطَّب	يشَطَّب	2	to cross out (with several strokes), erase (many things at once)
شَطَح	يِشطَح	1	to go on an excursion, make a trip, have a picnic, to wander, stroll
شَطَف	يُشطُف	1	to wash, to rinse
شَعَر	يُشعُر	1	to feel, percieve, be aware
شَعَط	يِشعَط	1	to burn, scorch
شَعَّل	يشَعَّل	2	to light, ignite, set on fire
شَغَل	يِشغَل	1	to occupy, keep busy
شَغَّل	يشَغَّل	2	to employ, make someone/something work, to operate, use, set in motion (machine etc)
شَفَط	يُشفُط	1	to suck up, suck in, to slurp
شِفَق	يِشفَق	1	to take pity on, be merciful, have mercy
شَفى	يِشفي	1	to cure, heal (particularly by God)
شِفي	يِشفى	1	to get better, recover
شَقّ	يشُقّ	1	to crack, split, breat open, rend, to push ajar, open just a crack, to visit the sick
شَقَح	يِشقَح	1	to cut open, slice open, split open
شَقَّح	يشَقَّح	2	to cut up
شَكّ	يشَكّ	1	to doubt, distrust, suspect, to thread, string, to impale, to prick, to stab
شَكَر	يُشكُر	1	to thank
شَكشَك	يشَكشَك	[4]	to pierce repeatedly, stab repeatedly
شَكَّل	يشَكَّل	2	to be, constitute, to assemble, form, put together, to vocalize, vowelize, put in voweles (in written arabic)
شَكى	يِشكي	1	to complain, suffer (from), tell on, inform against, snitch on
شَكَى/اِشْتَكَى	يشْكي/يشْتَكي		to complain
شَلَح	يِشلَح	1	to take off, remove (clothes or shoes)
شَلَع	يِشلَع	1	to pull hard, take out
شَلفَق	يشَلفَق		to cut corners, be lax, be negligent
شَمّ	يشَمّ	1	to smell, sniff
شَمَّت	يشَمَّت	2	to give someone something to gloat over, to provide an opportunity to gloat
شِمَت	يِشمَت	1	to gloat (over another's misfortune)
شَمَّر	يشَمَّر	2	to roll up (sleeves
شَمَّس	يشَمَّس	2	to be sunny, to air, spread out to dry in the sun, to perform a function at a Christion service
شَمشَم	يشَمشَم	[4]	to sniff around
شَمْشَم	يشَمْشِم		to sniff around
شَمَّع	يشَمَّع	2	to wax, seal with wax
شَمَل	يِشمَل	1	to include, comprise
شَمَّم	يشَمَّم	2	to let (someone) smell (something)
شَنغَل	يشَنغَل		to hook, hook open, hook back
شَنَق	يُشنُق	1	to hang (put to death)
شَنهَق	يشَنهَق		to bray (of donkey)
شَهَق	يِشهَق	1	to bray, to sob, gulp, gasp
شَهّى	يشَهّي	2	to whet one's appetite, water the mouth
شَوَّش	يشَوَّش	2	to confuse, muddle, disturb, distort
شَوَّق	يشَوَّق	2	to whet one's appetite, arouse one's curiosity
شَوَّه	يشَوَّه	2	to deform, distort, disfigure, deface
شَوى	يِشوي	1	to roast, to grill
شَيَّب	يشَيَّب	2	to give one grey hairs, turn one's hair white
شَيَّد	يشَيَّد	2	to build well
شَيَّع	يشَيَّع	2	to disseminate, distribute, publicize, spread, to attend (a funeral)
صاب	يصيب	1	to hit (target etc), to injure, afflict, befall, happen to (misfortune), to touch
صاح	يصيح	1	to shout, scream, to crow (rooster)
صاحَب	يصاحَب	3	to befriend, make a friend
صاد	يصيد	1	to hunt, fish, to catch (by hunting/fishing)
صادَر	يصادَر	3	to confiscate, impound, expropriate
صادَف	يصادَف	3	to run into, come across, meet by chance
صادَق	يصادَق	3	to approve, authorize, sanction, ratify
صار	يصير	1	to happen, begin, turn out, become, be now
صاصى	يصاصي	3	to cheep, chirp
صاصَى	يصاصي		to chirp, to cheep
صالَح	يصالَح	3	to make up with, become reconciled with, make peace with
صام	يصوم	1	to fast
صان	يصون	1	to watch over, guard, protect, mind
صَبّ	يصُبّ	1	to pour, pour out
صَبَّح	يصَبَّح	2	to bless with a good morning (of God), to say good morning
صَبَر	يُصبُر	1	to be patient, wait patiently
صَبَّر	يصَبَّر	2	to stuff (taxidermy)
صَبَغ	يِصبَغ	1	to dye, paint (easter egg?)
صَحّ	يصَحّ	1	to happen, be possible, come along
صَحّ	يصُحّ	1	to get better, recover, be alright
صَحَّح	يصَحَّح	2	to correct, rectify, amend, to straighten
صَحصَح	يصَحصَح	[4]	to get better
صَحّى	يصَحّي	2	to wake (trans), arouse, rouse, to warn, draw attention to
صِحي	يِصحى	1	to wake up, regain consciousness, to sober up, become aware/alert, to clear up (of weather)
صَدَر	يُصدُر	1	to be published, be issued, appear
صَدَّر	يصَدَّر	2	to export
صَدَف	يُصدُف	1	to happen, occur by chance
صَدَّق	يصَدِّق		to believe
صَدّى	يصَدّي	2	to rust, become rusty
صَرّ	يصُرّ	1	to tie up, truss up
صَرَّح	يصَرَّح	2	to declare
صَرَخ	يُصرُخ	1	to shout, scream
صَرَف	يُصرُف	1	to spend money, to use up, to change money, to dismiss, sack, fire
صَرَّف	يصَرَّف	2	to market, retail
صَعَّب	يصَعَّب	2	to make difficult
صَعَد	يُصْعُد	1	to rise, ascend
صَغَّر	يصَغَّر	2	to reduce, make smaller
صَفّ	يصُفّ	1	to line stuf up, arrange in a row, to queue, stand in line, stand in a row
صَفَّح	يصَفَّح	2	to plate, cover with plates, to armor
صَفرَن	يصَفرَن		to faint, pass out (to literally turn yellow)
صَفَّق	يصَفَّق	2	to clap (hands) (more formal word)
صَفَن	يُصفُن	1	to think, reflect, think in silence, be deep in thought
صَفّى	يصَفّي	2	to filter, strain, distil, refine, to be left, end up, to settle (bill), to liquidate, sell off
صِفي	يِصفى	1	to clear (intrans), become clean, become pure
صَقَل	يُصقُل	1	to polish, burnish, cut (diamond)
صَلَب	يُصلُب	1	to crucify
صَلَّب	يصَلَّب	2	to cross oneself, make the sign of the cross
صَلَّح	يصَلَّح	2	to mend, repair, fix
صِلَح	يِصلَح	1	to be good, be right, be suitable
صَلَّع	يصَلَّع	2	to go bald
صَمَد	يُصمُد	1	to stand firm, hold on, persist
صَمَط	يُصمُط	1	to burn (trans)
صَمَّم	يصَمَّم	2	to plan, design, to intend, be determined, make up one's mind
صَنَّف	يصَنَّف	2	to classify, arrange, sort (out)
صِهَل	يِصهَل	1	to whinny, neigh
صَوَّب	يصَوَّب	2	to aim, take aim
صوبَن	يصوبَن		to soap (trans)
صَوَّت	يصَوَّت	2	to vote (to voice)
صَوَّر	يصَوَّر	2	to photograph, take a photo, photocopy, illustrate
صوصى	يصوصي		to cheep, chirp
صَيَّح	يصَيَّح	2	to shout, scream, cause an uproar
صَيَّف	يصَيَّف	2	to spend the summer, to wear summer clothes
ضارَب	يضارَب	3	to speculate
ضاع	يضيع	1	to get lost
ضاف	يضيف	1	to add
ضايَن	يضايَن	3	to last, to hold out, to stick to
ضَبّ	يضُبّ	1	to collect, to put away, pack
ضَبَط	يُضبُط	1	to control, have under control
ضَحَّك	يضَحَّك	2	to amuse, make someone laugh
ضِحَك	يِضحَك	1	to laugh
ضِحِك	يضْحَك		to laugh
ضَحّى	يضَحّي	2	to sacrifice
ضَخَّم	يضَخَّم	2	to inflate, blow up
ضَرّ	يضُرّ	1	to harm, cause harm to
ضَرَب	يُضرُب	1	to hit, beat, to bomb, shell, to multiply
ضَرَط	يُضرُط	1	to fart, pass wind
ضَعَّف	يضّعَّف	2	to weaken
ضِعَف	يِضعَف	1	to become weak/thin, to lose weight
ضَغَط	يِضغَط	1	to press, to put pressure on, to compress
ضَلّ	يضَلّ	1	to stay, remain, to continue, keep on
ضَمّ	يضُمّ	1	to bring together, join, bring/take into
ضِمَن	يِضمَن	1	to promise, assure, guarantee
ضَوَّع	يضَوَّع	2	to lose, to waste
ضَوى	يِضوي	1	to light, turn on, give light, illuminate, shine
ضَيَّع	يضَيَّع	2	to lost, waste
ضَيَّف	يضَيَّف	2	to recieve hospitality, entertain, to offer freshments
طاب	يطيب	1	to get better, to heal
طار	يطير	1	to fly, fly away, to take off
طارَد	يطارَد	3	to follow, pursue, to stalk, harrass
طاش	يطوش/يطيش	1	to float
طاع	يطيع	1	to obey
طاف	يطوف	1	to float
طاق	يطيق	1	to endure, bear, (be able to) stand
طال	يطول	1	to reach, be long enough, to reach and grasp
طَبّ	يطُبّ	1	to fall, land, fall upon, descend upon
طَبَخ	يُطبَخ	1	to cook
طَبَّش	يطَبَّش	2	to smash up, bang up, wreck
طَبطَب	يطَبطَب	[4]	to pat, tap
طَبَع	يِطبَع	1	to print, to type, to stand
طَبَّق	يطَبَّق	2	to apply, put into practice, implement (law, theory, etc), to alter to fit, adapt to fit
طَبَّل	يطَبَّل	2	to drum
طَجّ	يطُجّ	1	to bounce, rebound, to fail, mess up, to come away empty handed
طَحَن	يِطحَن	1	to grind
طَحى	يِطحي	1	to fire, sack, give the book
طَخّ	يطَخّ	1	to fire, shoot
طَرْتَش	يطَرْتِش		to spray, to splash
طَرَح	يِطرَح	1	to subtract, to present, submit, pose (question)
طَرَّح	يطَرَّح	2	to perform an abortion on, cause to miscarry
طِرَح	بتِطرَح	1	to miscarry, have a miscarriage
طَرَد	يُطرُد	1	to expell, drive out
طَرَّز	يطَرَّز	2	to embroider
طَرَش	يُطرُش	1	to deafen
طَرَش	يُطرُش	1	to sprinkle, spray, splash (with water), to whitewash
طَرَق	يُطرُق	1	to knock, rap, to slam
طِري	يِطرى	1	to soften, become soft
طَزّ	يطُزّ	1	to bounce, rebound (in القدس), to fart (in جليل)x
طَزطَز	يطَزطَز	[4]	to fart repeatedly
طَشّ	يطُشّ	1	to sizzle, to roam, ramble, meander around
طَعَج	يِطعَج	1	to bend, to dent
طَعَّم	يطَعَّم	2	to inoculate, vaccine
طَعمى	يطَعمي		to feed (trans)
طَعْمَى	يطَعْمي		to feed, to give a beating
طَفَخ	يِطفَخ	1	to overflow, boil over, be full ot bursting
طَفى	يِطفي	1	to put out (fire etc), to switch off, turn off
طَفَى	يطْفي		to extinguish
طَقّ	يطُقّ	1	to pop, to click, to be fed up
طَقَّش	يطَقَّش	2	to crack, crack open (trans)
طَقًع	يطَقَّع	2	to click, snap (trans), to stand someone up / leave someone hanging / let someone down, to trick, dupe, double cross
طَل	يطُلّ	1	to overlook, look out on, look in (pay brief visit), drop on, drop by, pop in
طَلَب	يُطلُب	1	to ask for, request, to order
طَلَّع	يطَلَّع	2	to take up, bring up, take out, bring out
طَلّع	يطَلِّع		to take out
طِلِع	يطْلَع		to go up, to go out
طَلَّق	يطَلَّق	2	to divorce (one's wife?)
طِلَق	بتِطلَق	1	to have contractions, be in labor
طَلى	يِطلي	1	to coat
طَمَح	يِطمَح	1	to aspire, strive, be ambitious
طِمَع	يِطمَع	1	to envy, to covet, hanker after
طَمَّن	يطَمَّن	2	to reassure
طَنَّش	يطَنَّش	2	to disregard, ignore, turn a blind eye
طَهَّر	يطَهَّر	2	to purify, cleanse, disinfect, circumsize
طَوَّب	يطَوَّب	2	to register (property)
طوبَر	يطوبَر		to construct a wooden form (for pouring concrete)
طَوبَر	يطَوبِر		to make moulds (pouring concrete)
طَوَّق	يطَوَّق	2	to surround, encircle
طَوَّل	يطَوَّل	2	to last, continue, take [a long] time, to lengthen, extend, to let down (clothes)
طَوّل	يطَوِّل		to lengthen
طِوَل	يِطوَل	1	to become longer/taller
طومَل	يطومَل		to bend over
طَوى	يِطوي	1	to fold
طَيَّب	يطَيَّب	2	to cure, make better
طَيَّر	يطَيَّر	2	to cause to fly, to blow away
ظَبَط	يُظبُط	1	to control, to fit, to work out
ظَبَّط	يظَبَّط	2	to fit (trans), adjust, regulate
ظَلَم	يُظلُم	1	to wrong, oppress, treat unjustly
ظَنّ	يظَنّ	1	to think, to suspect
ظَهَر	يِظهَر	1	to appear, become evident, to seem
عاد	يعيد	1	to repeat, do something again
عاد	يعود	1	to return, recur, do still, do again
عادى	يعادي	3	to be hostile
عاذ	يَعوذ	1	to take refuge, seek protection
عار	يعير	1	to lend
عارَض	يعارَض	3	to oppose, disagree
عاز	يعوز	1	to need, require
عاش	يعيش	1	to live, be alive
عاشَر	يعاشَر	3	to associate with, be in contact with
عافى	يعافي	3	to restore health, to keep someone healthy
عاقَب	يعاقَب	3	to punish
عالَج	يعالَج	3	to treat, take care of
عام	يعوم	1	to float
عامَل	يعامَل	3	to treat, behave towards
عان	يعِين	1	to help
عانَد	يعانَد	3	to resist (someone) stubbornly, to argue with (someone) persistently
عانى	يعاني	3	to suffer
عاوَد	يعاوَد	3	to repeat, do again
عاوَن	يعاوَن	3	to help
عايَد	يعايَد	3	to wish someone happy (religious?) holidays
عايَر	يعايَر	3	to embarras, cause to feel ashamed, make fun of, mock
عَبَّد	يعَبَّد	2	to surface, to pave
عبط	يُعبُط	1	to embrace, hug
عَبّى	يعَبّي	2	to fill, to fill in a form, to wind (a clock etc), to load a weapon
عَتَّم	يعَتَّم	2	to get dark, to darken, black out
عَجَب	يعجَب	1	to delight, please, satisfy, amaze
عَجَّب	يعَجَّب	2	to surprise, astonish, amaze
عَجَّل	يعَجَّل	2	to hurry, speed (up)
عَجّل	يعَجِّل		to hurry along, to speed up
عَجن	يجْعِن		to knead
عَجَن	يعجَن	1	to knead
عَدّ	يعَدّ	1	to count, consider to be
عَدّى	يعِدّي		to count
عَرَّب	يعَرَّب	2	to classify, sort, arrange, put in order
عَرَج	يُعرُج	1	to limp
عَرَض	يُعرُض	1	to present, put on, exhibit, show, to suggest, propose
عَرَّض	يعَرَّض	2	to display, exhibit, expose
عَرَّف	يعَرَّف	2	to inform, tell, introduce, define, hear confession
عِرِف	يعْرِف		to know
عِرَق	يَعرَق	1	to sweat, perspire
عَزّ	يعَزّ	1	to love, like
عَزَّب	يعَزَّب	2	to torture, cause suffering
عَزَر	يِعزَر	1	to forgive, absolve, excuse, exempt, to repremand, rebuke, tell off
عَزَّر	يعَزَّر	2	to reprimand, rebuke, tell off
عَزَّز	يعَزَّز	2	to strengthen, reinforce, consolidate
عَزَف	يِعزَف	1	to play (an instrument)
عَزَل	يعزَل	1	to isolate, to dismiss, fire, sack
عَزَّل	يعَزَّل	2	to clean, clean out, clear, clear out
عَزَم	يَعزَم	1	to invite
عَزّى	يعَزّي	2	to comfort, console, offer condolences
عَشَّب	يعَشَّب	2	to weed
عِشَق	يِعشَق	1	to fall in love with
عَشَّن	يعَشَّن	2	to wear for the first time
عَشّى	يعَشّي	2	to give someone dinner
عَصّ	يعُصّ	1	to press, squeeze, smash
عَصَّب	يعَصَّب	2	to bandage, to blindfold
عَصَر	يُعصُر	1	to wring, wring out, squeeze (fruit), press (olives etc)
عَضّ	يعُضّ	1	to bite
عَطَس	يُعطُس	1	to sneeze
عَطَّس	يعَطَّس	2	to sneeze several times
عَطَّش	يعَطَّش	2	to make thirsty
عِطَش	يَعطَش	1	to be thirsty, become thirsty
عَطَّل	يعَطَّل	2	to stop working, break down, to prevent someone from working, to interrupt someone's work
عَفَّش	يعَفَّش	2	to furnish, equip
عَفَّن	يعَفَّن	2	to get moldy, musty, rancid
عَفى	يَعفي	1	to excempt, excuse, pardon
عَقَد	يُعقُد	1	to tie (one) knot
عَقَّد	يعَقَّد	2	to tie (several) knots, to complicate, to give someone a complex, to thicken, congeal
عِقَل	يِعقَل	1	to be/become sensible, reasonable, intelligent, to gain understanding
عَقَّم	يعَقَّم	2	to sterilise
عَكَس	يَعكَس	1	to reflect
عَلَّق	يعَلَّق	2	to hang, hang up, put up, to interpret, comment on
عِلَق	يَعلَق	1	to stick, get stuck, get caught, become entangled, to begin
عَلَك	يِعلَك	1	to chew
عَلَّل	يعَلَّل	2	to hold a تَعليلة, to justify, explain, give reason for
عَلَّم	يعَلَّم	2	to teach, to mark, indicate, earmark
عِلِم	يعْلَم		to know
عَلَّى	يعَلّى		to raise, to elevate
عَلّى	يعَلّي	2	to raise, make higher
عَمَّد	يعَمَّد	2	to baptise, have someone baptised
عَمَّر	يعَمَّر	2	to build
عَمَّل	يعَمَّل	2	to produce pus
عِمِل	يعْمَل		to do
عَمَّم	يعَمَّم	2	to generalize, make generalizations
عَمى	يَعمي	1	to blind, dazzle
عَمَى	يعْمِي		to blind
عَنّ	يعَنّ	1	to groan
عَنتَر	يعَنتَر		to boast, brag
عَنَّد	يعَنَّد	2	to be stubborn, persist stubbornly
عَنوَن	يعَنوَن		to address (a letter etc)
عَنَى	يعْني		to mean
عَوَّد	يعَوَّد	2	to accustom, condition, get someone used to something
عَوَر	يِعوَر	1	to blind in the eye
عَوَّر	يعَوَّر	2	to injure, hurt
عَوَّض	يعَوَّض	2	to compensate, pay compensation
عَوَّق	يعَوَّق	2	to hold up, detain, delay, hinder, stand in the way of
عَوّى	يعَوّي	2	to bark, howl
عَيَّد	يعَيَّد	2	to celebrate a (religious) holiday
عَيَّر	يعَيَّر	2	to embarass, humiliate, insult, tease cruelly
عَيَّط	يعَيَّط	2	to shout, scream, to call, call out, to cry (in some areas)
عَيَّن	يعَيَّن	2	to fix, set, assign, appoint, to aim
غاب	يغيب	1	to be absent/away, to set (of sun)
غار	يغار	1	to be jealous
غار	يغار	1	to protect jealously, care for
غار	يغار	1	to be ticklish
غازَل	يغازَل	3	to court
غاص	يغوص	1	to dive
غاوَز	يغاوَز	3	to treat preferentially, to favor
غَبّ	يغُبّ	1	to soak up, absorb, to slurp
غَبَّر	يغَبَّر	2	to cover with dust, (in some areas) to remove dust
غَبَّش	يغَبَّش	2	to become blurred
غِدَر	يِغدَر	1	to be able, can
غَدّى	يغَدّي	2	to give lunch (to)
غَرّ	يغُرّ	1	to decieve, mislead
غَربَل	يغَربَل		to sieve, sift
غَرَّد	يغَرَّد	2	to sing (bird)
غَرَز	يِغرَز	1	to plant, insert, stick into, stab
غَرَّز	يغَرَّز	2	to sink (intrans)
غَرَس	يِغرَس	1	to plant
غَرغَر	يغَرغَر	[4]	to gargle (in some areas), to tickle (in some areas)
غَرَّق	يغَرَّق	2	to drown (trans), immerse, to soak, drench, to sink, scuttle
غِرَق	يِغرَق	1	to drown, sink, be immersed in
غَرّى	يغَرّي	2	to glue
غَزّ	يغُزّ	1	to prick, stab, jab, stick into
غَزَل	يِغزَل	1	to spin (woll, cotton, etc)
غَزى	يغَزي	1	to raid, invade
غَسَل	يِغسَل	1	to wash, to launder
غَسَّل	يغَسَّل	2	to wash (hands, face, etc)
غَشّ	يغُشّ	1	to decieve, cheat, dupe
غِشي	يِغشى	1	to faint, explode, burst up, crack up (with laughter)
غَصَب	يُغصُب	1	to force, compel, to rape
غَضّ	يغُضّ	1	to lower one's glance, to disregard
غِضَب	يِغضَب	1	to be angry
غَطّ	يغُطّ	1	to immerse, dip
غَطَس	يُغطُس	1	to dive, submerge
غَطّى	يغَطّي	2	to cover, cover up, hide
غِفَل	يِغفَل	1	to fail to notice, pay no attention, be inattentive, be observant
غِفي	يِغفى	1	to fall asleep, drop off
غَلَب	يِغلَب	1	to conquer, defeat, win
غَلَّب	يغَلَّب	2	to be a nuisance, disturb
غَلَّط	يغَلَّط	2	to mislead, cause to make a mistake, to disturb (in some areas)
غِلَط	يِغلَط	1	to make a mistake, be wrong
غِلِط	يغْلَط		to be wrong
غَلى	يِغلي	1	to boil (trans and intrans)
غَلَى	يغْلي		to boil
غَلّى	يغَلّي	2	to raise the price of, charge a high price
غَلَّى/غِلي	يغَلّي/يغْلَى		to increase (in value)
غِلي	يِغلى	1	to become more expensive, go up in price
غَمَر	يغَمَر	1	to embark on an adventure, to risk
غَمَز	يِغمَز	1	to wink
غَمَض	يُغمُض	1	to close (intrans, of eyes)
غَمَّض	يغَمَّض	2	to close (eyes)
غَمَّق	يغَمَّق	2	to make deeper, to deepen
غِمي	يِغمى	1	to faint
غَنّى	يغَنّي	2	to sing
غِني	يِغنى	1	to get rich, become wealthy
غَيَّر	يغَيَّر	2	to change something
غَيَّم	يغَيَّم	2	to get cloudy
فَئفَئ	يفَئفَئ		to say 'fe, fe' all the time (a kinda speech defect)
فات	يفوت	1	to pass (time mainly), to enter, come in, go in
فاتَح	يفاتَح	3	to start talking to, get into a conversation with, bring up a subject
فاجَأ	يفاجِئ		to surprise
فاجَئ	يفاجَئ	3	to surprise
فار	يفور	1	to boil, boil over
فارَق	يفارِق		to be parted from, to have bid farewell to
فاز	يفوز	1	to win, be victorious, to attain, accomplish
فاصَل	يفاصَل	3	to bargain
فاض	يفيض	1	to overflow, flood
فاق	يفيق	1	to wake up
فاقَس	يفاقَس	3	to bump (easter) eggs together (traditional festive children's game)
فَتَح	يِفتَح	1	to open
فَتَّح	يفَتَّح	2	to open (of eyes)
فَتَّش	يفَتَّش	2	to look for, search for, seek, to search, carry out a search, to supervise, oversee
فَتفَت	يفَتفَت	[4]	to crumble, make into crumbs
فَتَن	يِفتَن	1	to charm, fascinate
فَتَن	يِفتَن	1	to inform against, tell on
فَجَّر	يفَجَّر	2	to blast, blow up, detonate
فَحَص	يِفحَص	1	to examine
فَخَّم	يفخم	2	to honor, treat respectfully, to pronounce emphatically
فَرّ	يفُرّ	1	to run away, flee, to wander around
فَرَج	يِفرَج	1	to relieve, grant a respite
فَرَّج	يفَرَّج	2	to show, show round
فَرجى	يفَرجي		to show
فَرْجَى	يْفَرْجِي		to show
فِرَح	يِفرَح	1	to be happy/glad, to be pleased
فَرَد	يِفرَد	1	to scatter, spread (out) (intrans)
فَرشى	يفَرشي		to brush
فَرَض	يِفرَض	1	to impose, to assume
فَرَّغ	يفَرَّغ	2	to empty
فَرَق	يِفرَق	1	to differ, be different, to divide, seperate, distinguish, to part one's hair
فَرَّق	يفَرَّق	2	to separate, divide to disperse, distribute, to differentiate, distinguish
فَرَك	يُفرُك	1	to rub, to polish
فَركَش	يفَركَش		to trip (someone) up
فَرَم	يُفرُم	1	to chop up
فَزّ	يفَزّ	1	to jump up, get up abruptly, start
فَزَع	يِفزَع	1	to rush to (someone's) aid
فَسَد	يِفسَد	1	to inform against, tell on, blow the whistle on
فَسَّد	يفَسَّد	2	to stir up trouble, to slander, speak ill of
فَسَّر	يفَسَّر	2	to explain, interpret
فَشّ	يفَش	1	to vent, pour out, to burst, to lance
فَشَخ	يِفشَخ	1	to wound in the head
فَشَر	يِفشَر	1	to boast, brag, show off, to tell tales, tell lies
فَشَق	يُفشُق	1	to jump over, skip over
فَشَّق	يفَشَّق	2	to skip, leave out
فَشَّل	يفَشَّل	2	to cause to fail, to obstruct, frustrate, to disappoint, let down
فِشَل	يِفشَل	1	to fail
فَشى	يِفشي	1	to spread something
فَشّى	يفَشّي	2	to spread around
فَصَل	يِفصَل	1	to dismiss, sack, expel, separate
فَصَّل	يفَصَّل	2	to detail, describe in detail, to cut out (cloth)
فَضَح	يِفضَح	1	to scandalize, shame, disgrace, dishonor (publicly), show up, bring to disrepute, make shameful facts public
فَضَّل	يفَضَّل	2	to favor, prefer
فِضل	يِفضَل	1	to be left over
فَضّى	يفَضّي	2	to vacate, empty
فِضي	يِفضى	1	to empty, become free/unoccupied, to make time for
فَطَر	يُفطُر	1	to eat breakfast break a fast, stop fasting
فَطَّس	يفَطَّس	2	to stink
فَطَم	يُفطُم	1	to wean
فِطَن	يِفطَن	1	to remember, recall
فَطَّن/فَطَّر	يفَطَّن/يفَطَّر	2	to remind
فَعَص	يِفعَص	1	to squash, crush, flatten
فَعَط	يِفعَط	1	to scatter, flee, run away
فَعفَل	يفَعفَل		to pick over, search through
فَقَح	يِفقَح	1	to cut open, lance
فَقَد	يِفقَد	1	to lose (usually abstract), to be bereaved, lost a family member, to check up on, keep an eye on
فَقَّس	يفَقَّس	2	to hatch
فَقَع	يِفقَع	1	to burst
فَقَّع	يفَقَّع	2	to burst something, make something burst
فَقفَل	يفَقفَل		to blister
فَكّ	يفَكّ	1	to untie, undo, loosen (knot rope etc), to solve, decipher, to remove, take off
فَكَّر	يفَكَّر	2	to think
فَكّر	يفَكِّر		to think, to assume
فَكسَس	يفَكسَس		to fax, send a fax
فَكفَك	يفَكفَك	[4]	to disentangle, undo (knots), to dismantle, take apart
فَلّ	يفَل	1	to leave
فَلَّت	يفَلَّت	2	to let go, release, set free
فِلَت	يِفلَت	1	to escape, slip away
فَلَح	يِفلَح	1	to plough, cultivate, till
فَلفَل	يفلفل	[4]	to boil (rice) in water
فَلَّل	يفَلَّل	2	to fill up (with gas etc) (from english)
فَلّى	يفَلّي	2	to search (through), ransack
فَنّ	يفَنّ	1	to toss, flip a coin
فَهَّم	يفَهَّم	2	to explain, make understand
فَهّم	يفَهِّم		to explain
فِهَم	يِفهَم	1	to understand
فِهِم	يفْهَم		to understand
فَوَّت	يفَوَّت	2	to bring in, let in, let through, put in
فَوّت	يفَوِّت		to let through
فَوَّد	يفَوَّد	2	to authorize, empower, give full authority
فودَس/فَيدَس	يفودَس/يفَيدَس		to take a holiday, be on holiday
فَوَّر	يفَوَّر	2	to boil (intrans)
فورَص	يفورَص		to go on holiday, take a vacation, spend a holiday
فَوَّل	يفَوَّل	2	to bring bad luck
فَيَّق	يفَيَّق	2	to wake someone up
قابَل	يقابَل	3	to interview, have a meeting with
قاد	يقود	1	to lead, command, conduct
قارَن	يقارَن	3	to compare, draw a comparison
قاس	يقيس	1	to measure, gauge, take measurements, to try on, to compare, equate
قاصَص	يقاصَص	3	to punish (usually within home/school)
قاطَع	يقاطَع	3	to boycott, shun
قاقى	يقاقي	3	to cluck
قال	يقول	1	to say, tell, talk
قام	يقوم	1	to get up, stand up, rise, to do, implement, carry out, undertake, to begin, start (to do something)
قام	يقيم	1	to remove, take off, take away
قاهَر	يقاهَر	3	to bother, annoy, harass
قَاوَم	يقاوَم	3	to withstand, resist, oppose
قَبَر	يِقبَر	1	to bury
قَبَض	يُقبُض	1	to catch, seize, to get/recieve (money)
قَبَع	يِقبَع	1	to tear off
قِبَل	يِقبَل	1	to accept, agree
قَتَل	يِقتَل	1	to kill, murder, beat, hit, thrash
قَحّ	يقُحّ		to cough
قَحَط	يِقحَط	1	to scratch, scrape
قَحقَح	يقَحقَح	[4]	to cough several times, clear one's throat
قَدَح	يِقدَح	1	to drill, make a hole
قَدَّح	يقَدَّح	2	to make/drill several holes
قَدَّر	يقَدَّر	2	to estimate, value, appreciate, to decree, ordain, seal someone's fate (said of God)
قِدِر	يقْدَر		to be able
قَدَّس	يقَدَّس	2	to sanctify, say mass
قَدَّف	يقَدَّف	2	to row (a boat)
قَدَّم	يقَدَّم	2	to advance, move forward, serve, present, offer, submit
قَرّ	يقَرّ	1	to confess
قَرَّب	يقَرَّب	2	to bring closer, to draw closer, to approach, go near
قِرَب	يِقرَب	1	to be related to (family)
قَرَص	يُقرُص	1	to pinch, to sting, to bite (snake, mosquito)
قَرَض	يُقرُض	1	to lend (something which is not itself returned, but paid back in kind)
قَرَط	يُقرُط	1	to gnaw, crunch, to mispronounce ( ر usually)
قَرَّف	يقَرَّف	2	to nauseate, make someone feel sick
قِرَف	يِقرَف	1	to feel sick, be nauseated, feel nauseous
قَرفَص	يقَرفَص		to sit cross-legged
قَرقَع	يقَرقَع		to croak, to clatter, to rumble
قَرمَز	يقَرمَز		to squat, crouch, sit on one's haunches
قَرمَط/قَرقَط/قَرقَش/قَرمَش	يقَرمَط/يقَرقَط/يقَرقَش/يقَرمَش		to gnaw/crunch (depending on the area)
قَروَص	يقَروَص		to pinch lightly, pinch several times, pinch repeatedly
قِري	يِقرى	1	to read
قِرِي	يقْرَا		to read
قَسَم	يِقسَم	1	to halve, divide (in two), to divide (math)
قَسَّم	يقَسَّم	2	to divide, divide up, apportion, allocate
قِسي	يِقسى	1	to harden (intrans), to become hard, to treat harshly
قَشَّب	يقَشَّب	2	to become callused, develop calluses
قَشَّر	يقَشَّر	2	to peel
قَشَط	يُقشُط	1	to skim, skim off, to scrape, scrape off
قَشَّط	يقَشَّط	2	to rob
قَصّ	يقَصّ	1	to cut (with scissors), to get cut (hair)
قَصَد	يُقصُد	1	to mean, intend
قَصَر	يُقصُر	1	to plaster, to apply a smooth layer of concrete, to roughcast (wall)
قَصَّر	يقَصَّر	2	to shorten, make shorter, take a shortcut, to fall short, fall behind
قِصَر	يِقصَر	1	to become shorter
قَصَف	يِقصَف	1	to bomb, to shell
قَضى	يِقضي	1	to judge, spend (time), to fulfil, take care of
قَضى	يِقضي	1	to kill, exterminate
قَضّى	يقَضّي	2	to spend time
قَطَب	يُقطُب	1	to stich, stich up, suture
قَطَر	يُقطُر	1	to drop (ie put drops in eye), put drops in
قَطَّر	يقَطَّر	2	to drop a liquid, put drops in, to distil, filter
قَطَع	يِقطَع	1	to cut, cut in half, to stop, cut off, interrupt, disconnect, to buy (ticket), to cross, to leave behind, leave without
قَطَّع	يقَطَّع	2	to cut up, to interrupt, to take across, lead across, help across
قَطَف	يُقطُف	1	to pick, harvest, gather
قَعَد	يُقعُد	1	to sit, stay, begin, be inactive, have the day off
قَعَّد	يقَعَّد	2	to seat/sit someone
قَفَر	يُقفَر	1	to unmask, expose, discover the truth, find out about
قَفَز	يِقفَز	1	to jump, leap, bound
قَفَّل	يقَفَّل	2	to lock
قَلّ	يقَلّ	1	to decrease, dwindle, grow less, grow fewer
قَلَب	يِقلَب	1	to turn upside down or inside out, to turn over (trans), to change one's mind
قَلَّب	يقَلَّب	2	to turn over several times, to flick through, to zap (TV?)
قَلَّد	يقَلَّد	2	to imitate, copy
قَلَّص	يقَلَّص	2	to reduce, cut down (on)
قَلَع	يقْلَع		to remove, to take out, to extract, to take off clothes
قَلعَط	يقَلعَط		to dirty, make dirty, make a mess of
قِلَق	يِقلَق	1	to become anxious/worried/concerned, to be troubled
قِلِق	يقْلَق		to worry, to be anxious
قَلَّل	يقَلَّل	2	to reduce, decrease
قَلَّم	يقَلَّم	2	to stripe, make stripes, to mark
قَلى	يِقلي	1	to fry lightly
قَلّى	يقَلّي	2	to fry (for a long time)
قَمَّط	يقَمَّط	2	to put a diaper/nappy on (a baby), change diaper
قَنَّن	يقَنَّن	2	to smell stale (intrans)
قَنَّن	يقَنَّن	2	to limit, restrict, ration, be sparing with
قَهَر	يِقهَر	1	to bother, annoy, upset, cause unhappiness
قَوَّر	يقَوَّر	2	to hollow out, to core
قَوَّس	يقَوَّس	2	to shoot
قَوّى	يقَوّي	2	to strengthen
قِوي	يِقوى	1	to become stronger, regain strength, to overcome
قَيَّد	يقَيَّد	2	to bind, shackle, limit, confine, to take notes, record, write down, register
قَيَّس	يقَيَّس	2	to fit (someone) for, to let (someone) try on
كاد	يكاد	1	to be on the point of doing something, [to] almost [do something]
كاغةَ	يكاغي		to babble, to prattle
كافَئ	يكافَئ	3	to recompense, reward
كافَح	يكافَح	3	to combat, fight (against), wage war on
كافى	يكافي	3	to reward, recompense
كان	يكون		to be
كَبّ	يكُبّ	1	to spill, pour away, throw out
كَبَت	يِكبَت	1	to repress, bottle up
كَبَّر	يكّبَّر	2	to make bigger, enlarge, to think someone's older than they are, to exaggerate, blow out of proportion
كِبَر	يِكبَر	1	to grow, get bigger, age
كِبِر	يكْبَر		to grow up
كَبَس	يِكبَس	1	to press, to click (computer mouse), to rain (sudden heavy rain), to arrive unexpectedly, to raid, to pickle, preserve, conserve, to press (dried fruit)
كَبَّس	يكَبَّس	2	to press hard, press repeatedly
كَبكَب	يكَبكَب	[4]	to spill in small quantities at intervals
كَبْكَب	يكَبْكِب		to spill (in small quantities)
كَبّى	يكَبّي	2	to fall forward
كَتّ	يكُتّ	1	to fall (leaves), to fall out (hair), to peel (paint, skin), to shake (carpet), to flick (cigarette, so the ash falls off)
كَتَب	يكْتُب		to write
كَتَّر	يكَتَّر	2	to increase, multiply
كِتر	يِكتَر	1	to be many, be numerous, increase in number
كَتَم	يِكتَم	1	to heal, heal up, close up (of wound)
كَثَّف	يكَثَّف	2	to compress, concentrate, intensify, thicken
كَحَّل	يكَحَّل	2	to put kohl (eyeliner) or ointment on the eyes
كَدَّس	يكَدَّس	2	to hoard, amass, accumulate
كَذب	يكْذِب		to lie
كَرّ	يكُرّ	1	to unravel (trans and intrans)
كَربَل	يكَربَل		to sieve
كَرَّر	يكَرَّر	2	to repeat, do again, do repeatedly, to purify, refine
كَركَب	يكَركَب	[4]	to make a mess, leave something in a mess
كِرَم	يِكرَم	1	to be treated with respect, be honored
كِرَه	يِكرَه	1	to hate
كَزّ	يكَزّ	1	to grind yo teeth
كَزَب	يِكزَب	1	to lie
كَزَّب	يكَزَّب	2	to refute, disprove, prove someone is lying, deny
كَزكَز	يكَزكَز	[4]	to grind yo teeth
كِسَب	يِكسَب	1	to gain, acquire, win
كَسَح	يِكسَح	1	to tell off, repremand, put someone in their place
كَسَر	يِكسَر	1	to break, to defy, to turn
كَسَّر	يكَسَّر	2	to smash, break into several pieces
كَش	يكَش	1	to shoo, shoo away
كَشَر	يِكشَف	1	to find, discover, reveal, disclose, expose, uncover، +على to examine
كَشَّر	يكَشَّر	2	to frown
كَعوَك	يكَعوَك		to be frizzy
كَفَر	يُكفُر	1	to be an unbeliever, be an infidel
كِفَل	يِكفَل	1	to vouch for, guarantee, to stand bail for
كَفَّن	يكَفَّن	2	to shroud, wrap in a shroud
كَفى	يِكفي	1	to be enough, be sufficient
كَفى	يِكفي	1	to protect, spare, keep from harm
كَفّى	يكَفّي	2	to be enough, be sufficient, suffice
كَلبَش	يكَلبْش		to handcuff
كَلَح	يِكلَح	1	to fade, become colorless
كَلَّس	يكَلّْس	2	to be furred up (covered with a coating of limescale deposited by hard water)
كَلَّف	يكَلّْف	2	to commission, charge, entrust (with an undertaking), to cost
كَلَّل	يكَلّْل	2	to crown, to perform a (christian) marriage ceremony
كَمَش	يِكمْش	1	to grab, seize, snatch a handful
كَمَّل	يكَمّْل	2	to complete, finish, to go on, keep going, continue
كَمّل	يكَمِّل		to complete
كَمَّم	يكَمّْم	2	to muzzle
كَنَّس	يكَنّْس	2	to sweep
كَهرَب	يكَهرَب		to electrify
كوفَل	يكوفَل		to diaper, put a diaper on a baby
كَوَّم	يكَوَّم	2	to pile (up), heap (up)
كَوَّن	يكَوَّن	2	to make, assemble, put together, form, shape, formulate
كَوى	يِكوي	1	to iron, to burn (causing injury), to cauterise
كَيَّف	يكَيَّف	2	to enjoy, have a good time, amuse, give pleasure, adjust, regulate, adapt, air condition
كَيَّل	يكَيَّل	2	to measure out
لاحَظ	يلاحَظ	3	to notice, observe, percieve
لاحَق	يلاحَق	3	to follow, trail, pursue, chase
لاقى	يلاقي	3	to find, encounter, meet, to consider (something to be something)
لاك	يلوك	1	to chew
لام	يلوم	1	to reproach, blame
لان	يلين	1	to become soft/flexible, to relent, soften, become amenable
لاهَت	يلاهَت	3	to be out of breath, to pant
لَبَّس	يلَبَّس	2	to dress (someone else)
لِبِس	يلْبَس		to put on clothes
لَبَّق	يلَبَّق	2	to call by a nickname, to call names
لِبَق	يِلبَق	1	to match, go with, suit, look nice on, look good on
لَبّى	يلَبّي	2	to grant (a request), to accede, comply
لَتَغ	يِلتَغ	1	to mispronounce (refers to ر as غ usually)
لَتَّم	يلَتَّم	2	to veil/cover/mask one's face
لَحّ	يلَحّ	1	to pressure, urge, implore
لَحَس	يِلحَس	1	to lick
لَحَّق	يلَحَّق	2	to manage (to do something), to get around to
لِحَق	يِلحَق	1	to catch, catch up (with), to manage (to do something), to follow, pursue
لَحَّن	يلَحَّن	2	to set to music, to compose
لَخَّص	يلَخَّص	2	to summarise, state briefly, outline
لَدَغ	يلَدَغ	1	to mispronounce (a letter)
لَزّ	يلَزّ	1	to crowd together (trans and intrans)
لَزَّق	يلَزَّق	2	to stick (trans and intrans)
لِزَق	يِلزَق	1	to stick (intrans)
لِزَم	يِلزَم	1	to be necessary
لَسَع	يِلسَع	1	to bite
لَطّ	يلَطّ	1	to slap lightly
لَطَش	يُلطُش	1	to slap
لَطَّش	يلَطَّش	2	to know a smattering (of a language), to speak a language poorly
لَطَف	يُلطُف	1	to show kindness, be nice
لَعَّب	يلَعَّب	2	to organize play/games (to cause to play)
لِعِب	يلْعَب		to play
لَعبَط	يلَعبَط		to squirm, wiggle, flap about
لَعَن	يِلعَن	1	to curse
لَعَن/نَعَل	يلْعَن/ينْعَل		to curse
لَعى	يِلعي	1	to be sick, be nauseated, feel nauseous, to nauseate, make sick
لَغمَز	يلَغمَز		to smear, dirty
لَغمَط	يلَغمَط		to smear, dirty
لَفّ	يلَفّ	1	to wrap (up), to coil, wind, to turn
لَفَت	يِلفَت	1	to turn, direct, attract (attention)
لَفَح	يِلفَح	1	to chill (wind), to burn (sun), to hit lightly
لَفَظ	يُلفُظ	1	to pronounce, utter
لَفَّع	يلَفَّع	2	to diaper, put a diaper on someone
لَفَّق	يلَفَّق	2	to invent, make up, fabricate
لَفلَف	يلَفلَف	[4]	to gloss over, to cover up
لَقّ	يلَقّ	1	to lap, lick up
لَقَط	يلَقَط	1	to catch, pick up, recieve, take in
لَقَّن	يلَقَّن	2	to prompt, make (someone) repeat
لَقى	يلقي	1	to find
لَكَش	يُلكُش	1	to touch, poke, nudge
لَمّ	يلَمّ	1	to collect, gather, tidy up, pick up
لَمَّح	يلَمَّح	2	to hint
لَمَع	يِلمَع	1	to shine, sparkle, gleam, glitter, to be in spasm, to go out, get ricked, get cricked, start to hurt
لَملَم	يلَملَم	[4]	to gather together, to pick up, to pack
لَمْلَم	يلَمْلِم		to gather together (scattered objects)
لَهَت	يِلهَت	1	to pant, be out of breath
لَوَّث	يلَوَّث	2	to pollute
لَوَّح	يلَوَّح	2	to wave
لولَح	يلولَح		to sway, swing back and forth
لَوَّن	يلَوَّن	2	to color, color in
لَوى	يِلوي	1	to bend, to twist
لَيَّن	يلَيَّن	2	to make soft, make supple, to moderate
مارَس	يمارَس	3	to practise (a profession), to apply, exert, use
ماطَل	يماطَل	3	to put off, temporize, give someone the runaround
ماع	يميع	1	to melt, liquify, to become flabby, to behave flirtatiously
مال	يميل	1	to bend, slope, incline, lean, to be inclined to, in favor of
مَثَّل	يمَثَّل	2	to represent, to act
مَحى	يِمحي	1	to erase, rub out, obliterate, wipe out, wipe away
مَخَّخ	يمَخَّخ	2	to brainwash
مَخَّط	يمَخَّط	2	to wipe a nose
مَدّ	يمَدّ	1	to extend, stretch, reach out, to lay (cables, pipes, etc)
مَدَح	يِمدَح	1	to praise, speak highly of
مَدَّد	يمَدَّد	2	to extend, prolong, to renew
مَدَّر	يمَدَّر	2	to be bad (of an egg)
مَرَّج	يمَرَّج	2	to massage
مَرجَح	يمَرجَح		to swing (trans), push (someone on a swing)
مِرَض	يِمرَض	1	to fall sick, be ill
مَرَق	يمْرُق		to pass by
مَرَّق	يمَرَّق	2	to pass (trans), to let in, let through, let past
مَرَّن	يمَرَّن	2	to train, exercise, drill (trans)
مَزّ	يمَزّ	1	to nibble, have a snack
مَزَع	يِمزَع	1	to tear, tear up, tear out
مَزَّع	يمَزَّع	2	to tear up, tear apart, tear to pieces
مَسّ	يمَسّ	1	to hurt, offend
مَسَح	يِمسَح	1	to wipe (off/away), to polish, to plane (wood), to survey (to measure land)
مَسَّك	يمَسَّك	2	to let (someone) hold, to give (someone something) to hold, to lend, place at someone's disposal
مِسِك	يمْسِك		to hold
مَسّى	يمَسّي	2	to give an evening (of god), to wish someone a good evening
مَشَّط	يمَشَّط	2	to comb
مَشّى	يمَشّي	2	to lead, make go, to help walk, to let go/walk, to set in motion, carry out
مِشي	يمْشي		to walk
مَصّ	يمَصّ	1	to suck
مَضَغ	يِمضَغ	1	to chew
مَضى	يِمضي	1	to pass, go by, to sign
مَضَى	يمْضي		to sign
مَضّى	يمَضّي	2	to pass (the time), to spend (time)
مَطّ	يمُطّ	1	to draw tight, stretch (trans), to be drawn tight, stretch (intrans), to drawl
مَعجَن	يمَعجَن		to stick with putty, to fill holes with filler
مَعَّص	يمَعَّص	2	to mash, crush
مَعَط	يِمعَط	1	to pluck out, pull out (hair)
مَعَّط	يمَعَّط	2	to tear, tear out, pull out (hair)
مَغَط	يِمغَط	1	to stretch (trans/intrans), to be stretchy, be elastic
مَغيَب	يمَغيَب		to ignore, close one's eyes to, avoid, stay away from, keep clear of
مَقلَت	يمَقلَت		to gossip
مَكَّن	يمَكَّن	2	to make possible
مَلّ	يمَلّ	1	to get bored, to get tired of
مَلَّح	يمَلَّح	2	to salt, to season
مَلَّس	يمَلَّس	2	to smoothe, level, straighten, to stroke, caress
مَلَص	يُملُص	1	to slip (out)
مَلّى	يمَلّي	2	to fill
مَنَح	يِمنَح	1	to grant, give, award
مَنَع	يمْنَع		to prevent
مَنَّن	يمَنَّن	2	to keep going on about something good (that you did)
مَوَّت	يمَوَّت	2	to kill, bring about a death
مَوَّل	يمَوَّل	2	to fund
مَوَّن	يمَوَّن	2	to fund, supply
مَيَّز	يمَيَّز	2	to distinguish, differentiate, tell the difference, discriminate, to discriminate against, to give preferential treatment to
مَيَّل	يمَيَّل	2	to tilt, tip, incline, to deviate, turn aside, come in, drop by
ناح	ينوح	1	to wail, whine
نادى	ينادي	3	to call out, announce, call, send for
نادَى	ينادي		to call out, to announce
نازَع	ينازَع	3	to be dying, be in the throes of death, to struggle
ناسَب	يناسَب	3	to suit, be suitable, to be related by marriage
نافَس	ينافَس	3	to compete with
ناقَش	يناقَش	3	to discuss, exchange ideas
ناقَض	يناقَض	3	to contradict
ناك	ينيك	1	to fuck
نام	ينام	1	to lie down, rest, to sleep
ناوَل	يناوَل	3	to give, hand (over), pass, deliver
نَبَت	يُنبُت	1	to grow, sprout (intrans)
نَبَح	يِنبَح	1	to bark
نَبَّش	ينَبَّش	2	to search, rummage, dig
نَبَع	يِنبَع	1	to gush out, well up, result from, stem from
نَبَّه	ينَبَّه	2	to wake (trans), to warn
نَتَج	يِنتَج	1	to result, ensue, arise, stem from
نَتَش	يِنتَش	1	to snatch
نَتَع	يِنتَع	1	to cough, splutter (engine)
نَتَّع	ينَتَّع	2	to cough/sputter repeatedly (of engine)
نَتَف	يِنتَف	1	to pluck, pluck out
نَتَّف	ينَتَّف	2	to pluck, pluck out, pull out
نَتَق	يُنتُق	1	to vomit, be sick, throw up
نَجَح	يِنجَح	1	to succeed
نِجَح	يِنجَح	1	to succeed
نِجِح	يِنْجَح		to succeed
نَجَد	يِنجَد	1	to rescue, come to the aid of
نَجَّس	ينَجَّس	2	to pollute, contaminate, defile
نَجّى	ينَجّي	2	to save, rescue, to preserve
نِحِف	يِنْحَف	1	to lower, drop, relax, loosen, let down, let go
نَخّ	ينَخّ	1	to kneel down, to give in, capitulate, knuckle under
نَخَب	يِنخَب	1	to choose
نَخَّخ	ينَخَّخ	2	to cause to kneel down (camel)
نَخَّل	ينَخَّل	2	to sift, sieve
نَدَب	يِندَب	1	to mourn, lament
نَدَر	يِندَر	1	to vow, make a vow
نِدَم	يِندَم	1	to regret, be remorseful, feel remorse
نَرفَز	ينَرفَز		to be annoyed, be irritated
نَزّ	ينَزّ	1	to drip, leak
نَزَّل	ينَزَّل	2	to bring down, let down, drop off, lower, reduce
نَزّل	ينَزِّل		to bring down
نِزِل	ينْزَل		to descend
نِسَح	يِنسَح	1	to put on weight, get fat
نَسَف	يِنسَف	1	to blow up
نَسَّق	ينَسَّق	2	to arrange, put in order, coordinate
نَسّى	ينَسّي	2	to cause to forget
نِسى	ينْسَى		to forget
نِسي	يِنسى	1	to forget
نَشّ	ينَشّ	1	to fan
نَشَر	يُنشُر	1	to hang out (washing), to publish, publicize, announce, to saw
نَشَّف	ينَشَّف	2	to dry (trans)
نِشَف	يِنشَف	1	to dry, dry up, dry out
نِشِف	ينْشِف		to dry up
نَشَق	يُنشُق	1	to sniff, snuffle
نَشَل	يِنشَل	1	to bring up and out to draw (water), to extricate, to steal
نَشّى	ينَشّي	2	to starch (of washing?)
نَصَب	يُنصُب	1	to set up, erect, to pitch (a tent), to set (a trap, ambush) to con, to forget to pay
نَصَح	يِنصَح	1	to advise
نَصَّح	ينَصَّح	2	to fatten, make fatter
نِضَج	يِنضَج	1	to ripen, mature
نَضَّف	ينَضَّف	2	to clean
نَضّف	ينَضِّف		to clean
نَط	ينُط	1	to jump, to leap
نَطّ	ينُطّ		to jump, to leap
نَطَح	يِنطَح	1	to butt (something a cow does?)
نَطَق	يُنطُق	1	to utter, speak, pronounce
نَطنَط	ينَطنَط		to bounce (trans), to jump up and down, jump about, skip about
نَطْنَط	ينَطْنِط		to bounce, to jump up and down
نَظَر	يُنظَر	1	to look, take a look at, examine
نَظَّم	ينَظَّم	2	to organize, arrange, put in order
نَعَّس	ينَعَّس	2	to send to sleep, make tired
نِعَس	يِنعَس	1	to feel drowsy, feel sleepy, to doze, nod off
نَعَق	يِنعَق	1	to croak
نَعَل	ينعَل	1	to curse
نَعى	يِنعي	1	to announce a death
نَغَل	يُنغُل	1	to swarm, swarm with
نَفَخ	يُنفُخ	1	to breathe out, blow (on), blow up, inflate
نَفَّز	ينَفَّز	2	to implement, carry out
نَفَّس	ينَفَّس	2	to breathe out, exhale, to deflate
نَفَش	يِنفَش	1	to swell (in water, damp weather)
نَفَع	يِنفَع	1	to benefit, help, be of use, do (someone) good, to suit, be suitable, to be valid
نَفَل	يِنفَل	1	to rummage, to scatter
نَفَّل	ينَفَّل	2	to scatter about, leave in a mess, leave lying around, to rummage through
نَفى	يِنفي	1	to exile, banish, deport, to deny, to negate
نَقّ	ينُقّ	1	to complain, grumble, make a fuss
نَقَّب	ينَقَّب	2	to pluck, pluck out, pull out
نَقَر	يُنقُر	1	to hollow out, to core
نَقَز	يُنقُز	1	to get a fright, be frightened, be startled, to jump (in fright)
نَقَّز	ينَقَّز	2	to frighten, startle, give (someone) a fright
نَقَش	يُنقُش	1	to engrave
نَقَّص	ينَقَّص	2	to reduce, lessen, to miss
نِقَص	يِنقَص	1	to be lacking, be missing
نِقِض	ينْقَص		to be lacking, to have missing something
نَقَّط	ينَقَّط	2	to drip, to cause to drip, to drop (trans, of liquid), to give a present
نَقَع	يِنقَع	1	to soak (trans) in water, leave to soak, to stand up (trans), to leave hanging
نَقَل	يِنقُل	1	to move (trans), transfer, convey, carry, to copy, to move (house)
نَقَّل	ينَقَّل	2	to move (trans), to dictate (make copy)
نَقنَق	ينَقنَق	1	to stammer, stutter
نَقى	ينَقي	1	to choose, select, sift, pick over (rice lentils etc)
نَقّى	ينَقّي		to choose, to select, to pick
نَكَّت	ينَكِّت		to tell jokes
نَكَر	يِنكَر	1	to deny
نَكَش	يُنكُش	1	to hoe, to poke teasingly
نَمّ	ينَمّ	1	to slander, gossip maliciously
نَمَّر	ينَمَّر	2	to number
نَمى	يَنمو/يِمني	1	to grow, develop, grow up
نَمّى	ينَمّي	2	to develop/promote something
نَهَب	يِنهَب	1	to loot
نَهَر	يِنهَر	1	to scold, tell off
نَهَق	يِنهَق	1	to bray (of donkey etc)
نهَنّى	يِتهَنّى		to enjoy
نَوَّر	ينَوَّر	2	to flower, bloom, blossom, to light, illuminate
نَوَّع	ينَوَّع	2	to vary (trans), diversify
نَوَّم	ينَوَّم	2	to send to sleep, to hypnotise
نَوى	يِنوي	1	to mean, intend
نَيَّم	ينَيَّم	2	to send to sleep, put to bed, put someone up for the night, find a bed for
هاجَر	يهاجَر	3	to emigrate
هاجَم	يهاجَم	3	to attack
هاش	يهوش	1	to attack, display hostility
هال	يهيل	1	to collapse
هَبّ	يهَبّ	1	to blow, gust, blow in gusts, to flicker, to catch fire, to be flammable (the common element here is suddenness)
هَبَط	يُهبُط	1	to fall, collapse, drop (prices), to come/go down, to land
هَبَّط	يهَبَّط	2	to lower, reduce, to cause to collapse, to cause to subside
هَتَف	يِهتف	1	to cheer, applaud
هَجَّر	يهَجَّر	2	to make someone emigrate, to force someone out of their country
هَجَم	يِهجَم	1	to attack, pounce
هَجّى	يهَجّي	2	to spell
هَدّ	يهَدّ	1	to break down, demolish, to cover, mate with
هَدَّد	يهَدَّد	2	to threaten
هَدَف	يِهدَف	1	to aim, have a goal
هَدَم	يِهدَم	1	to demolish, completely destroy
هَدى	يِهدي	1	to give (as a present)
هَدّى	يهَدّي	2	to calm, soothe, to alight, land
هِدي	يِهدى	1	to calm down, become calm
هَرّ	يهُرّ	1	to flow out, leak out, escape, be emitted, be discharged, (in some areas) to have diarreah
هَرَب	يُهرُب	1	to run away, escape
هَرَّب	يهَرّب	2	to force to flee, put to flight, to smuggle
هَرى	يِهري	1	to wear out
هَزّ	يهَزّ	1	to shake, jolt, rock, to shrug
هَزَق	يهزَق		to drill
هَستَر	يهَستَر		to be(come) hysterical
هَشَت	يِهشَت	1	to boast, brag, talk big, to tell tall stories
هَضَم	يُهضُم	1	to digest
هَضَّم	يهَضَّم	2	to digest (when talking of human beings)
هِلَك	يِهلَك	1	to be worn out, be exhausted
هَمّ	يهَمّ	1	to concern, worry, to preoccupy, to interest, matter, be important
هَمَّر	يهَمَّر	2	to growl
هَندَم	يهَندَم		to spruce up, dress up smartly (trans)
هَنّى	يهَنّي	2	to congratulate, to cause enjoyment, to make happy
هَوَّد	يهَوَّد	2	to judaise, make Jewish
هَوَّش	يهَوَّش	2	to egg on, stir up, to sick (a dog)
هَوّى	يهَوّي	2	to air out, ventilate, (in some areas) to fart
هَيَّئ	يهَيَّئ	2	to prepare
هَيَّج	يهَيَّج	2	to incite, stir up
واجَه	يواجَه	3	to come face to face with, confront, face up to, to encounter, come across, run into
وازَن	يوازَن	3	to equal in weight, be balanced, to strike a balance, equalize
واظَب	يزاظَب	3	to persevere, keep up, persist
وافَق	يوافَق	3	to agree with
وَبَّخ	يوَبَّخ	2	to reprimand, scold, tell off
وَثَق	يَثَق	1	to trust, rely on
وَجَد	يَجَد	1	to find
وَجَّع	يوَجَّع	2	to hurt, cause pain
وِجَع	يوجَع	1	to hurt
وَجَّه	يوَجَّه	2	to direct, to aim
وَحَّد	يوَحَّد	2	to unite
وَدَّع	يوَدَّع	2	to take one's leave, say goodbye
وَدّى	يوَدّي	2	to bring, take
وَرَّث	يوَرَّث	2	to leave a legacy, bequeath
وِرَث	يَورَث/يِرَث	1	to inherit
وَرجى	يوَرجي		to show (rural speech)
وَرَّط	يوَرَّط	2	to get someone in trouble, to embroil, involve
وَرَّم	يوَرَّم	2	to cause to swell
وِرَم	يورَم	1	to swell up
وَرّى	يوَرّي	2	to show
وَزّ	يوَزّ	1	to buzz, to incite, set against
وَزَّع	يوَزَّع	2	to divide up, distribute, share out
وَزَّن	يوَزَّن	2	to weigh (rural speech?)
وَزوَز	يوَزوَز	[4]	to buzz, hum
وَسَّخ	يوَسَّخ	2	to soil, dirty
وَسَّع	يوَسَّع	2	to extend, expand, enlarge, to let out (clothes)
وَشَّم	يوَشَّم	2	to tattoo
وَشوَش	يوَشوَش	[4]	to whisper
وَصَف	يَوصَف	1	to describe, to prescribe
وَصَل	يوصَل	1	to join, connect (trans)
وَصَّل	يوَصَّل	2	to take, bring, convey, give a lift
وَصّل	يوَصِّل		to take (somewhere)
وِصِل	يوصَل		to arrive
وَصّى	يوَصّي	2	to recomment, prescribe, to command, ask/tell (to do sth), to order (restaurant etc)
وَضَّح	يوَضَّح	2	to explain, clarify, clear up
وَضَع	يَضَع	1	to put, place, lay
وَطَّن	يوَطَّن	2	to settle (trans), cause (someone) to become sedentary
وَطَّى	يوَطِّي		to lower
وَطّى	يوَطّي	2	to lower, bow (trans), bend down (intrans)
وَظَّف	يوَظَّف	2	to employ, to invest
وَعَد	يَوعَد	1	to promise
وَعَظ	يِوَظ/يوعَظ	1	to preach
وَعّى	يوَعّي	2	to wake someone up, to warn
وِعي	يَوعى	1	to wake up (intrans), to be careful
وَفَّر	يوَفَّر	2	to save up, economize
وَفَّق	يوَفَّق	2	to reconcile, accommodate, cause (someone) to succeed (of God)
وَفى	يَوفي/يفي	1	to keep (a promise), pay (a debt)
وَقَّع	يوَقَّع	2	to knock down, knock over, drop
وِقَع	يَوقَع	1	to fall, fall over, fall down, drop (intrans)
وِقِع	يِوقَع		to drop
وَقَّف	يوَقَّف	2	to stop (trans), end (trans), to turn off, to pull up, stop (intrans), to stand (trans and intrans), to stand still, to park (trans and intrans), to arrest, detain, hold
وَقّف	يوَقِّف		to pull up
وَلَد	يَولَد	1	to give birth
وَلَّد	يوَلَّد	2	to generate, produce, to deliver a baby, assist in childbirth
وِلَد	يولَد	1	to be born, or give birth
وَلَّع	يوَلَّع	2	to light, kindle, set fire to, to catch fire
وَلوَل	يوَلوَل	[4]	to wail, howl, to lament
وَنّ	يوَنّ	1	to whine, snivel
وَنوَن	يوَنوَن	[4]	to whine, snivel
يِئَس	يِئَس	1	to despair
يِبَس	ييبَس	1	to dry out, to dry up